〇|零
cmn|yue
一丁點兒|少少
一上一下|一上一落
一下|下
一串|一搊
一些|啲
一件事|單嘢
一件|件
一伙|一班
一個人|單拖
一個人得頭彩|獨贏
一個|個
一個勁兒|起勢
一個勁|起勢
一個半小時|個半鐘
一個多|個幾
一個子兒|一個崩
一倍|一個開
一共|總共
一刀兩斷|一拍兩散
一切|各樣
一到|一嚟到
一刻鐘|一個骨
一力承擔|一腳踢
一動不動|死估估
一匹布那麼長|一疋布咁長
一千元紙幣|金牛
一千多|千幾
一半|成半
一去無蹤|冇尾飛堶
一口一口|啖啖
一口氣|一輪嘴
一口氣話說完|一輪嘴
一口痰|一涿口水痰
一口鍋裏吃飯|同撈同煲
一口飯|一啖飯
一向|不摟
一味背誦|死背
一品紅|聖誕花
一回事|一條數
一團亂|一碟齋
一團糟|一鑊泡
一團飯|一䊆飯
一坨屎|一涿屎
一場空|得個吉
一塊一塊|一舊舊
一塊|一達
一塊兒|同埋
一塊兒掙錢|同撈同煲
一塊布|一帗布
一塊石頭|一䊆石頭
一塊肉|一䊆肉
一塊蛋糕|一䊆蛋糕
一塌糊塗|烏里單刀
一夜夫妻|霧水夫妻
一大兩小|一大兩細
一大堆|一大籮
一大幫人|大堆頭
一大摞|一大疊
一大早兒|朝早
一大早|大早
一大群|一大班
一大頓|一大輪
一天|一日
一天到晚|一日到黑
一套|籠
一宗|一單
一定入選|入梗
一定|實
一定弄妥當|包搞掂
一定得|鬼唔望
一定是|梗係
一定會|實
一定有|梗有
一定要|一於
一定贏|冇得輸
一定需要|實要
一家人|一家大細
一家人家兒|一家人
一家劇院|一間劇院
一家老小|一家大細
一家老幼|一家大細
一家醫院|一間醫院
一家銀行|一間銀行
一家飯店|一間飯店
一對反義字|蜆殼字
一對|孖
一小半兒|細半
一小片|一笪
一小群人|一小撮人
一小點兒|少許
一層樓|闒
一巴掌|一巴
一年三熟|一年三造
一座座|一幢幢
一廳一室|闒
一心一意|埋頭埋腦
一怔|突兀
一愣|打躓
一手包辦|一腳踢
一手遮天|隻手遮天
一批|一眾
一技一長|一技旁身
一把|一揸
一把眼淚|一殼眼淚
一把鼻涕|一涿鼻涕
一拐|一入
一拐一拐|拐下拐下
一撮|一執
一支煙|一口煙
一整天|成日
一文不名|拍手冇塵
一方惡霸|草頭王
一早一晚|朝頭晚夜
一早|晨早
一時|一時間
一時性起|火遮眼
一晚上|過夜
一會|一陣
一會兒|一陣
一本書|本書
一朵雲|一舊雲
一根筋|四方木
一根蔗|一碌蔗
一條|條
一條牛|一隻牛
一樓|地下
一模一樣|餅印
一樣一個|鴛鴦
一樣|同
一橫一豎|一晝一戙
一次|一鑊
一次完成|一鑊熟
一次定死活|一次定生死
一次性|一次過
一次為止|一次過
一步一步|逐啲逐啲
一段|一橛
一段影片|條片
一段時間|牌
一段時間總計|頭尾
一氣|連氣
一氧化碳|煤氣
一泡尿|一涿尿
一流|冇敵
一準|實
一溜煙|一朕煙
一無所知|烏垂垂
一片空地|一笪空地
一片肉|一帗肉
一瓶|一罌
一生|一世
一生相對|做人世
一番|一輪
一疊|一棟
一瘸一瘸|拐下拐下
一百元|紅底
一盤|一碟
一目瞭然|一眼睇晒
一直|一味
一直到|至到
一直往前走|直行
一直按|撳實
一直服用|食開
一直望著|望實
一直玩|玩開
一直盯著|𥄫實
一直看著|睇實
一直走|直行
一眨眼|眨下眼
一眼看上去|驟眼睇
一瞥間|驟眼看
一瞬間|霎時
一知半解|半桶水
一碼歸一碼|數還數路還路
一窩蜂|柴哇哇
一竅不通|盲塞
一端向上仰起|翹
一端是尖|尖嘴
一籮籮|多籮籮
一米|咪
一絲不掛|光脫脫
一縷|一綹
一縷煙|一朕煙
一群|一眾
一群人|大堆頭
一老一小|一老一幼
一聲不吭|粒聲唔出
一聲不響|粒聲唔出
一肚怪|矮仔多計
一股煙|一朕煙
一腳踏空|踩錯腳
一般垃圾|一般廢物
一般產品|行貨
一般的規矩|例牌
一般般|麻麻地
一般|麻麻
一萬元|一盤水
一覽無遺|一眼睇晒
一角|一毫
一角銀幣|碎銀
一言以蔽之|一句講晒
一諾千金|牙齒當金使
一豎|一棟
一起一伏地動|跳
一起|一齊
一起來|齊嚟
一起打麻將的人|雀友
一起混|同煲同撈
一起玩|玩埋一份
一起生活|同煲同撈
一起跳|跳埋一份
一路順風|順風順水
一身臊|周身蟻
一輩子|成世
一連|連氣
一進|一入到
一進入|一入到
一進到|一入到
一道|一題
一道著名素菜|羅漢齋
一道裂縫|一條罅
一邊|一便
一邊兒|側便
一部電影|套電影
一部電腦|部電腦
一鍋端|一鑊熟
一鑊粥|一鑊泡
一開始就出錯|埋手打三更
一間酒樓|一家飯店
一陣子|一排
一陣間|一陣
一隻鞋|一隻屐
一雙|一孖
一雙鞋|一雙鞋
一面|一自
一項|一單
一頭牛|一隻牛
一餐|頓
一點不對|有少少
一點不留|清
一點也沒有|冇釐
一點事情|少少事
一點兒也不剩|渣都冇
一點兒|少少
一點兒辦法也沒有|一戙都冇
一點|少少
一點整|沓正一點
一點空兒也沒有|冇時閑
一點聲息|粒聲
一點轍兒都沒有|冇晒符
一點辦法也沒有|一戙都冇
一點點兒|少少
一點點|啲恁多
一鼻子灰|一面屁
一鼻孔出氣|一擔擔
一齊來|齊嚟
一齊合作|佮手佮腳
一齊喊|一齊嗌
一齊|齊齊
丁魚|狗棍
七上八下|十五十六
七八成|七七八八
七大姑八大姨|姨媽姑姐
七折八扣|七除八扣
七變花|臭花
七零八落|零星落索
七點整|沓正七點
丈人|外父
丈夫的舅母|舅奶奶
丈夫的舅父|舅老爺
丈夫|老公
丈母娘|外母
三個女人一台戲|三個女人一個墟
三八|八婆
三刻鐘|三個骨
三十五分鐘|七個字
三十分鐘|六個字
三十|卅
三合板|三佮板
三天兩頭|三日兩頭
三姑六婆|八卦婆
三心二意|心多多
三心兩意|心多多
三思|睇定啲
三日香|新屎坑
三明治|三文治
三極體|三極管
三歲看老|三歲定八十
三角架|狗髀架
三長兩短|冬瓜豆腐
三隻手|小手
三頭對案|三口六面
三點整|沓正三點
上一輩子作了孽|前世唔修
上下|上落
上下文|前文後理
上下顛倒|掉轉頭
上乘烹飪用湯|上湯
上了|讀過
上來|上嚟
上八輩子|古老十八代
上凍|結冰
上前來|埋嚟
上升|標升
上午|上晝
上半晌兒|上晝
上去|落
上司|頂頭
上吊|吊頸
上吊自殺|吊頸
上吐下瀉|又痾又嘔
上墳|拜山
上夜班|開夜
上大號|去屙屎
上好|家用
上學|返學
上小號|去屙尿
上層|上格
上岸|埋街
上年紀|幾十歲
上年紀的母親|老媽子
上弦|上鏈
上方|上高
上映|上畫
上氣不接下氣|氣羅氣喘
上漆|油油
上漲|起
上火|燥熱
上班值勤|出更
上班去做工|開工
上班|返工
上當|中招
上癮|有癮
上眼皮|眼檐
上碟|起鑊
上空|冇上裝
上窄下寬|奓腳
上等|揀手
上等貨|正嘢
上節胳膊|手瓜
上級|老細
上肩|起膊
上臂|手骨
上臂骨|手骨
上船|落船
上茶樓享受|歎茶
上菜|起菜
上街|出街
上衣兩側的縫|袷
上衣|衫
上課鐘響|打鋃鐘
上輩子欠的|前世唔修
上邊兒|上便
上門推銷者|行街
上門追債|拍門收數
上門追討債款|拍門收數
上陣|上馬
上電視|上鏡
上面|上高
上頭|上高
上香|裝香
上馬|去馬
上齒前突|哨牙
下一|第
下一輩子|第世
下不來臺|食貓麵
下不為例|一次過
下來|低嚟
下個|嚟緊
下兜齒|地包天
下冰雹|落雹
下功夫|畀心機
下午|下晝
下半晌兒|下晝
下去|落去
下回|下世投胎
下垂的弧形|嚲
下垂|耷
下場|落場
下定決心|立定心水
下定金|落定
下屬|旗下
下巴|下爬
下巴脫臼|甩下爬
下巴頦兒|下爬
下很冷的小雨|落雪水
下|手
下手|下欄
下方|下格
下晚兒|挨晚
下棋|捉棋
下次|第次
下毛毛雨|雨微微
下水|下欄
下水道|坑渠
下決心幹|殺起
下決心|扚起心肝
下流|烏糟
下流痞子|衰公
下班|放工
下眼皮|眼肚
下神|問仙
下襬|衫腳
下課|落堂
下賤|賤格
下足了工夫|落足工夫
下跪|跪
下車|落車
下載|取得
下邊|下便
下邊兒|下便
下錯|放錯
下鍋|落鑊
下陷|坐
下雨|落雨
下雨路滑|落雨斯濕
下雪|落雪
下面一格|下格
下面|下便
下頜骨關節|牙鉸
下頭|下底
下頷骨關節|牙骹
下館子|飲茶
不一定|冇定準
不三不四的朋友|豬朋狗友
不上不下|半天吊
不上算|不值
不世故|大情大性
不中不西|半唐番
不久以前|大早
不乖|曳曳
不乾淨的手段|哪渣手段
不乾淨的東西|污糟嘢
不乾淨|邋遢
不了|唔到
不了解情況|盲摸摸
不了解|矇查查
不介意|唔在乎
不伸出|縮
不但|唔止
不作假|君真
不作聲|不出聲
不佳|壞鬼
不來往|冇交易
不供應|欠奉
不俗|大臺
不保證|唔擔保
不倒翁|醉酒公仔
不倫不類|唔三唔四
不值一提|冇話頭
不值一說|冇話頭
不值|唔抵
不值得|唔抵
不值得考慮|諗唔過
不值得買|買唔過
不值錢之物|一隻屐
不值錢|爛賤
不值錢的命|爛命
不做|唔撈
不做工|不做
不停嘮叨|日哦夜哦
不停嘴|把口唔收
不停地|起勢噉
不停地跳腳|扎扎跳
不停地顫動|揗揗震
不停"|猛
不停|直落
不偷不摸|好手腳
不偷懶|勤力
不傷心才怪|唔傷心就假
不僅僅|唔單只
不僅只是|不單只
不僅|唔單
不僅是|唔單止
不像|唔似
不像樣|唔湯唔水
不像樣子|唔湯唔水
不像話|冇修
不兇|不惡
不光|唔淨只
不光彩|低威
不光是|唔淨只
不入時|老土
不公平|大細超
不公平對待|大細超
不再幹原來從事的職業|收山
不再幹|收山
不再想|息心
不出聲|唔聲
不分大小|沒大沒細
不分好壞|開眼盲
不分尊卑|沒大沒細
不分老幼尊卑|冇大冇細
不切實際|唔等使
不切實際地誇口|下爬輕輕
不划算|䎺唔過
不利索|論盡
不到|唔夠
不動產|物業
不勞而獲|乾
不十分|唔係幾
不及|唔夠
不反轉|唔反
不只|唔單只
不只是|不特只
不可一世|招積
不可以|唔得
不可否認|冇可否認
不可|唔得
不可挽回|冇得摱
不可收拾|雞毛鴨血
不可能不|鬼唔望
不可能|冇理由
不可變更|梗板
不可超越|冇得頂
不可靠|生蟲拐杖
不可靠的消息|流料
不吃未煮熟的東西|唔熟唔食
不吃虧|不輸蝕
不合常性|唔嗅米氣
不合常理|冇譜
不合常規|竅妙
不合情理|冇理由
不合時宜|老土
不合格|肥佬
不合理|冇厘頭
不合算|買唔過
不合群兒|未入沓
不合道理|冇理由
不吉利的事情|冬瓜豆腐
不吉利的日子|破日
不向|唔問
不含糊|均真
不吭聲兒|不出聲
不吭聲|唔聲
不吭聲嚇你一跳|唔聲唔聲嚇你一驚
不呆板|自然
不和|詏撟
不|唔
不！|唔好！
不問而取|鼠
不善交際|古縮
不善解人意|話頭唔醒尾
不善言辭|口拙
不喜歡|唔到位
不喜答話|十問九唔應
不單只是|不單只
不單|唔淨只
不單是|不特只
不固定|冇定準
不土不洋|半唐番
不在家|出門
不在意|不為意
不在摺兒上|有麝自然香
不堅實|鬆
不多的一些|些少
不多的數量|三幾
不多的日子|一頭半個月
不夠|未夠
不夠花|不夠洗
不夠開支|支支繃繃
不大一會兒|冇幾耐
不大可能|難
不大|唔係幾
不大好|麻麻
不大對頭|唔多妥
不大明白|唔係好明
不大舒服|唔多妥
不太|唔係幾
不太夠|好舋
不太差|唔差
不太理會|好少理
不太配合|唔多夾
不好不壞|中中哋
不好了|弊家伙
不好受|唔自在
不好對付|惡作
不好意思|唔該
不好應付|惡骾
不好打交道|惡死
不好用|擇使
不好的名字|衰名
不好的命|爛命
不好的結局|收科
不好看|冇睇頭
不好|苴斗
不好說話|惡死
不好辦|擇使
不如人|低威
不如|唔似
不嫁的女人|自梳
不存在|冇
不孝子|唔好仔
不孝順的兒子|忤逆仔
不守承諾|甩底
不安|閉翳
不安靜|鬧
不完整|碎
不定時|不時
不害臊|唔知醜
不容侵犯|有殺冇賠
不容易|不易
不容易看得上眼|眼角高
不密|疏
不實在|兒嬉
不實現諾言|失拖
不寬裕|繃繃繄
不專一|花心
不專心|心散
不對勁兒|唔係路
不對勁|唔係路
不對|唔啱
不對稱的兩扇門|鴛鴦門
不對稱|鴛鴦
不對頭|唔妥
不小|不細
不小心|唔覺意
不尖|倔
不就|尚唔
不就是|唔係
不就是嗎|唔係
不局促|自然
不工作|不做
不差|唔爭在
不已|到震
不帶東西|光身
不常|冇幾何
不平|唔抵
不平整|吊腳
不平整的角落|窿窿罅罅
不幹了|收檔
不幹|唔撈
不很|唔係幾
不得了|唔得掂
不得了啦|大件事
不得勁兒|唔妥
不得好死|冇乜好死
不必|唔使
不必在乎|好閑
不必懷疑|唔使問阿貴
不必說穿|畫公仔唔使畫出腸
不必道謝|唔使多謝
不忍看|冇眼睇
不快|計帶
不忿|唔抵
不怎麼|唔係好
不怎麼樣|麻麻
不怕|冇有怕
不怕吃虧|抵諗
不怕打|韌皮
不怕生下來就命不好|唔怕生壞命
不怕羞|唔怕醜
不怕虧本|唔計帶
不怕難為情|唔怕面懵
不情願|死死地氣
不想工作|搏炒
不想管|冇眼睇
不想|費事
不愛動|懶
不愛吃飯|冇飯癮
不愛幹活兒|懶
不愛惜|糟騭
不愛理人|唔瞅唔睬
不愛答理人|古縮
不愛答理人者|鼓氣袋
不愛說話|口密
不愛說話的姑娘|密實姑娘
不慌不忙|施施然
不慌亂|定過抬油
不懂世故|冇紋路
不懂事|唔識世界
不懂人情世故|唔熟性
不懂利害|唔知痛
不懂|唔識
不懂得事情危急|唔知死
不懂得人情世故|未入世
不懂得利害|未知死
不懂得|唔識得
不懂本行|未入門
不懂生活艱難|唔知米價
不懂禮貌|冇紋路
不懂變通|死估估
不成交|冇交易
不成人樣|落晒形
不成|唔掂
不成器|爛泥扶唔上壁
不成器的人|爛鬼
不成套的武術|散手
不成對兒|鴛鴦
不成整數|零丁
不成材|爛泥扶唔上壁
不成材的人|爛鬼
不成熟|唔夠飣
不成行列|離行離迾
不扎實|兒嬉
不打自招|鬼拍後尾枕
不扣衣紐|開懷解帶
不承認|牚
不拖不欠|冇拖冇欠
不拘小節|冇所謂
不拘禮|大情大性
不按規則辦事|偷雞
不捨|肉刺
不提供|欠奉
不擁有|冇
不放心|心掛掛
不放過|通殺
不敏捷的人|壽仔
不敢|唔夠膽
不敢強硬|口軟軟
不敢當|點係
不整齊|哩啡
不料|點知
不斤斤計較|抵得諗
不新鮮|涴
不斷地|一日到黑
不斷地跳|扎扎跳
不斷說髒話|連環爆粗
不方便|論盡
不方正|一岩一窟
不明不白|唔清唔楚
不明事理|唔化
不明亮|朦朦茶茶
不明理|懵
不明白|唔曉
不明道理|盲塞
不易死|禁死
不易變色或褪色|禁色
不是人|唔係人噉品
不是什麼好人|好人有限
不是個兒|唔係我手腳
不是冒牌|正牌
不是好兆|唔好意頭
不是很|唔係幾
不是我的個兒|唔係我手腳
不是戲言|講過算數
不是故意|唔在意
不是省油的燈|唔係嘢少
不是經常|有幾何
不是說嗎|又話
不是這麼說|唔係噉講
不是開玩笑|唔講得笑
不時|遇時
不時髦|老土
不會做人|唔熟性
不會做|做唔嚟
不會再來|欿唔返
不會動搖|打風打唔甩
不會幹活兒|姐姐噉手
不會累的腿|神仙腳
不會變通|迂滯
不會走|唔識行
不會轉變|死實
不服氣|唔忿氣
不樂意|唔到位
不標準|半咸淡
不機伶的人|壽仔
不機靈|話頭唔醒尾
不歡而散|一拍兩散
不正常|神
不正|斜
不正派|唔三唔四
不正當地謀利|食水
不正當的手段|哪渣手段
不正經|鬼馬
不死心|死心不息
不比別人差|唔輸蝕
不沾水|跣水
不注意|唔在意
不活動|冇㤢
不消說|唔在講
不消蹄|黃腫腳
不清楚|朦
不測|冬瓜豆腐
不滿意|唔妥
不滿足|唔夠喉
不為別的|冇他
不然|唔係
不然的話|唔係嘅話
不熟練者|初哥
不熱鬧|清靜
不牢|兒嬉
不特|不特只
不理不睬|唔瞅唔睬
不理會|懶理
不理睬|唔睬人
不甘心|唔忿氣
不用來了|唔使嚟
不用|唔使
不用客氣|唔使多謝
不用心|冇心機
不用怕|唔使慌
不用打算|唔使嚟
不用指望|唔使欿
不用水|乾
不用計較|冇計
不用說|唔使計
不用麻煩了|費事喇
不由得你不|唔到你唔
不留心|唔在意
不留神|唔覺意
不疲軟|直板
不盡人意|麻麻哋
不直|彎
不相上下|一擔擔
不相干|唔關事
不相投|絞唔埋纜
不相稱|失真
不相連|離行離捺
不相配|失真
不看一眼|不瞅不睬
不睡覺|戙起床板
不知不覺|唔驚唔覺
不知天高地厚|唔知死
不知就裏|矇查查
不知底細|胡胡混混
不知情|烏卒卒
不知所以|冇厘頭
不知所謂|冇厘頭
不知死活|唔知痛
不知為什麼|冇解
不知為甚麼|冇厘頭
不知羞恥|唔知醜
不知要倒霉|唔知衰
不知趣|唔通氣
不知身在何處|唔知埞
不知道有多快活|不知幾爽
不稀罕|唔恨
不稠|稀淋淋
不稱職|唔夠飣
不穩固|岋岋愩
不穩|岋
不穿鞋襪|除大赤腳
不答應|唔肯
不答理|不瞅不睬
不算什麼|冇計嘅
不算好|麻麻
不算|未算
不管三七二十一|有理冇理
不管了|冇眼睇
不管你|話之你
不管如何|幾大
不管它|有理冇理
不管怎樣|有理冇理
不管或不理睬|好少理
不管用|唔中用
不管|話晒
不管那麼多|有理冇理
不簡單|唔係嘢少
不粘身|爽汗
不精明|番薯
不精細|草
不純正的話|鹹水話
不純|雜
不結實|唔禁
不經常|耐唔中
不經心|唔在意
不經思考|唔經大腦
不緊不慢|唔嗲唔吊
不緊張|放
不缺|唔爭在
不羨慕|唔恨
不老氣|唔老餅
不耐煩|𤷪𤺧
不耐用|化學
不耽你的時間|唔阻你
不聞不問|懶理
不聰明|笨
不聲不響嚇你一跳|唔聲唔聲嚇你一驚
不聽人勸|自把自為
不聽別人意見|死硬撐
不聽話|逆意
不肯|唔制
不胖不瘦|不肥不瘦
不能再穿|不着得返
不能動彈|梗
不能吃|忌食
不能|咪
不能怪|唔怪得
不能成|做唔到
不能滿足需要|到喉唔到肺
不能給|給不到
不能自主的人|扯綫公仔
不能說笑|唔講得笑
不能走|唔走得
不能這麼說|唔係噉話
不能通行|屈頭
不脆|腍
不舊|新淨
不舒服|溼滯
不虛假|沒花假
不行|唔掂
不行時|過氣
不被人看重的人|茄哩啡
不要動|唔好㤢
不要命|狼胎
不要|唔好
不要想|息心
不要有前勁沒後勁|好頭好尾
不要緊|唔緊要
不要臉|唔顧面
不要說|咪話
不解人意|冇解
不言不語|木獨
不計較|何計
不該消受|受唔起
不該|瀉
不認前賬|反口覆舌
不認真|是但
不認識|唔識
不認賬|牚
不認輸|唔執輸
不說不知道|唔講唔知
不說也不知道|不說不知
不論|冇計嘅
不論如何|有理冇理
不論怎麼說|話晒
不講信用|冇口齒
不講理|冇賴
不講老實話|話三話四
不講道理者|番鬼佬
不講道理|蠻橫
不謝|唔使唔該
不識貨|開眼盲
不買就後悔|唔買就笨
不費勁的工作|懶佬工夫
不足|唔夠
不踏實|冇搭颯
不輕率|重
不辭勞苦|替生替死
不迎合人意|逆意
不近人情|倔情
不通人性|唔係人噉品
不通人情|唔嗅米氣
不通的路|屈頭路
不通|盟
不過，|之不過，
不過|之但係
不過來|唔掂
不過問|冇眼睇
不鋒利|屈
不錯|幾好
不開朗|古縮
不開胃|唔開胃
不開通|唔化
不閑|唔得閑
不關|唔關
不關心|冇心裝載
不隨和|澀滯
不隱蔽|明
不離開|傍
不難看|睇得過
不需要|使乜
不露縫隙|密實
不露財|財不露眼
不靈活|龍鍾
不靠譜|唔係路
不頂用|唔中用
不順人意|扭紋
不順利|唔掂
不順從父母意|逆意
不順從|逆意
不順眼|唔開胃
不願多幹事|惜手惜腳
不願干預|冇眼睇
不願意|唔制
不願管|懶理
不顯富|財不露眼
不顯老態|好禁老
不食言|有口齒
不馴服|扭計
不高|矮
不高興|晦氣
不鬆動|梗
不鬆|實
不鬆軟|實趯趯
丑腳|雜
丑角|丑生
且不說|姑勿論
且住|咪自
且|夾
且慢|咪住
世上的人良莠不齊|一種米養百種人
世界一流的球技|世界波
世間少有|冇人有
世面|大蛇屙尿
丟下|掉低
丟了|唔見
丟了它|擗著佢
丟人|失禮
丟人現眼|獻世
丟失|唔見
丟|揼
丟棄|擗
丟職|炖冬菇
丟臉|丟架
丟面子|落面
並|兼
並在一起|拍
並無其他|冇他
並聯|孖
丫頭|妹仔
中不溜|中停
中不溜兒|中中哋
中午|晏晝
中和|中和
中圈球|中界球
中國|唐
中國式|唐裝
中型公共汽車|中巴
中外混血兒|半唐番
中央|中心
中年婦女|阿嬸
中年男士|中坑
中式低層樓房|唐樓
中式便服|唐裝衫
中式女禮服|裙褂
中式樓房|唐樓
中式男女便裝|唐裝
中式短皮襖|皮衲
中式短褲|牛頭褲
中式菜肴|唐餐
中式衣服|唐裝衫
中式長皮襖|皮袍
中式飯菜|唐餐
中招|舐嘢
中文默寫|中默
中文默書|中默
中斷|掹開
中暑|感暑
中氣不足|唔夠氣
中氣不順|翳悶
中班|中更
中秋節次晚|追月
中空|通籠
中等|中停
中等身材|不肥不瘦
中…|緊…
中華汽車|中巴
中葯水劑|湯葯
中裝|唐裝
中選|入圍
中間|中心
中間人|橫手
中間凹下|癟
中頭獎|中頭馬
中風|爆血管
中餐|唐餐
串兒|打亂種
串綫|搭錯綫
串通|串埋
串通口供|夾口供
串通行騙|放白鴿
丸子|蛋
主事|話事偈
主人|事頭
主人房間|主人房
主射|操刀
主意|橋
主持|搞
主機|機身
主理|打理
主管人|老細
主管|大班
主臥室|主人房
主要|大多
主觀|執拗
主辦|主催
主辦人|搞手
主辦者|搞手
主顧|客仔
久煮的好湯|老火靚湯
久病之人|藥煲
久|耐
么兒|孻仔
么|孻
之中|入邊
之前|之先
之外|之餘
之後|及後
乍到|暴到
乍看上去很漂亮|霎眼嬌
乍看|霎眼
乏|癐
乒乓板|波板
乒乓球拍|波板
乖女孩|乖乖女
乖孩子|乖豬
乖巧男孩|乖乖仔
乖巧|精乖
乖覺|醒定
乘勝追擊|食住條水
乘坐|搭
乘客|搭客
乘客逃票|坐霸王車
乘機撈一把|博亂
乘機會溜走|借水遁
乘法口訣|九因歌
乘涼|唞涼
乘興|打鼓趁興
乘車兜風|游車河
乘車漫游|游車河
乘車遊覽|遊車河
乜東西|乜東東
九九歌|九因歌
九十多|九廿幾
九死一生|死過返生
九點整|沓正九點
九龍巴士|九巴
乞丐|乞兒
乞討|乞米
也|亦
也包括進去|打埋
也可以|都得
也夠|都夠晒
也對|亦啱
也就是說|即係話
也很聰明|都幾醒
也是|都係
也有限|極有限
也算上|打埋
乳房|奶
乳汁|奶
乳白電燈泡|奶膽
乳罩|胸圍
乳臭小子|鼻涕蟲
乳臭|臊
乳酪|芝士
乳齒|乳牙
乾兒|乾
乾兒子|契仔
乾噎|乾哽
乾奶酪|芝士
乾妹|契妹
乾娘|契媽
乾媽|契媽
乾巴巴|乾骾骾
乾弟|契弟
乾心兒|生乾精
乾旱天氣|旱天
乾杯|飲勝
乾涸|涸涸哋
乾淨利落|乾手淨腳
乾淨整齊|企理
乾渴|涸
乾炒|熇
乾燥|乾涸
乾爸爸|契爺
乾爹|契爺
乾牡蠣肉|蠔豉
乾着急|肉緊
乾瞪眼|眼痑痑
乾脆|一於
乾脆地剪東西的聲音|輯
乾薪|乾工
乾電池|電芯
乾麵|撈麵
亂七八糟|烏里麻茶
亂了套|一鑊泡
亂了營|七國咁亂
亂來一氣|胡天胡帝
亂來|混吉
亂吵吵|嘈生晒
亂吹一氣|亂車廿四
亂哄哄|立立亂
亂墳崗|亂葬崗
亂套|亂龍
亂寫|老作
亂得一塌糊塗|七國咁亂
亂成一團|亂晒坑
亂扔|躂
亂扯|亂噏
亂摸亂弄|手多多
亂擲|狂掟
亂攀關係|認親認戚
亂猜|斷估
亂玩|迆住嚟玩
亂發號施令|亂指廿四
亂碰亂撞|亂咁舂
亂糟糟|亂龍
亂翻|抄
亂花錢|亂揈
亂葬崗子|亂葬崗
亂說一氣|牙譫譫
亂說一通|大隻講貪口爽
亂說|亂噏
亂說話|衰多口
亂講|亂噏
亂走|蜎
亂跑|貢
亂跳一通|生蝦噉跳
亂踩|蹅
了不起|架勢
了吧？|喇啩？
了|咗
了！|喇！
了？|喇？
了嗎？|未？
了"|嘞
了沒？|咗未？
了結|收科
了解|知
事不關己|闊佬懶理
事事順利|風生水起
事件|畸士
事例|例規
事先作出計划和安排|預
事兒|事幹
事兒多|多事
事務所|樓
事實|實
事情公開|揭盅
事情|嘢
事情弄糟|甩底
事情後果嚴重|大鑊
事情暴露|甩底
事情沒做好|唔掂
事情的全過程|頭尾
事情的最精采處|戲肉
事情緊急|水浸眼眉
事情辦砸了|攪汪
事情關係|事關
事情鬧大了|攪到咁大鑊
事情麻煩|一鑊泡
事態嚴重|大劑
事緣|事關
二人不和|貼錯門神
二人|兩個
二十五分鐘|五個字
二十分鐘|四個字
二十|廿
二姊|二家姐
二婚頭|翻頭婆
二房東|包租婆
二房東太太|包租婆
二手貨|夜冷
二把刀|二打六
二把手|二偈
二極體|二極管
二毛|二毫
二百五|蒸生瓜
二車|二偈
二鍋頭白酒|雙蒸酒
二鍋頭|雙蒸
二頭肌|老鼠仔
互不認識|三唔識七
互換位置|調轉
互相比較|格價
互相熟悉|相熟
互相要好|老友
互相賭氣|鬥負氣
互通信息|打同通
五光十色|五顏六色
五分鐘|一個字
五分頭|中間界
五十五分鐘|十一個字
五十分鐘|十個字
五大三粗|牛高馬大
五屜櫃|五筒柜
五彩繽紛|七彩
五斗櫃|五筒柜
五更起床|起五更
五柳料之一|錦菜
五色果|五時果
五色梅|臭花
五花兒|五花腩
五花肉|間花腩
五行缺水|五行欠水
五角|五毫
五顏六色|花哩碌
五香花生仁兒|南乳肉
五香花生仁|南乳肉
五香花生|南乳花生
五點整|沓正五點
井臺|井欄
些|啲
些小|些少
些微|趣趣地
些許|些少
亞塞拜然|亞塞拜彊
交代|話落
交叉架住|徑
交叉|繑
交屋|交吉
交工|交吉
交往|拍拖
交待|交帶
交手|埋牙
交手打架|博手
交接班|交更
交換庚帖|落帖
交朋友|做朋友
交款處|收銀處
交流電|溼電
交班|交更
交納會費|供會
交給|畀過
交通不便|撠腳
交通堵塞|打晒纈
交通費|舟車費
交通阻塞|交通擠塞
交還|交返
交配|打頭
交錢|磅水
交際|充撐
享受|歎
享受生活|儃世界
享樂|梳芙
享清福|嘆世界
享福|嘆世界
亮亮|光晟晟
亮|光
亮光光|閃閃令
亮堂|光猛
亮堂堂|光劖劖
亮晶晶|爉爉令
亮燈|着燈
亮眼|醒目
亮謎底|開估
亮麗|光鮮
亳不相關|唔相干
亳無辦法|冇符
人人|個個
人人討厭|逢人憎
人來瘋|見人就鬧
人們|啲人
人傑|人板
人力車|手車
人口|口
人品|人事
人多打瞎亂|人多煠狗唔腍
人多擁擠|偪人
人多擁擠貌|人頭涌涌
人多熱鬧|眾
人字旁|企人邊
人字梯|擘梯
人家|人哋
人家吃完才到達|飯後鐘
人小|人仔細細
人小卻心眼兒多|人細鬼大
人小心眼兒多|老奀茄
人小點子多|人細鬼大
人山人海|人頭涌涌
人工養殖蝦|基圍蝦
人形玩具|公仔
人怕出名豬怕壯|人怕出名豬怕肥
人情比紙薄|人情紙咁薄
人情淡薄|淡過蔗尾
人情薄如紙|人情紙咁薄
人情關係|人事
人懶|朝食晚洗
人手|腳
人有計謀|鬼靈精怪
人材|料
人格卑下|爛笪笪
人格墮落|折墮
人漸漸瘦下去|陰乾
人熊|熊人
人生總有相逢之時|山水有相逢
人的個子|個頭
人的氣色|血色
人的精神狀態|氣
人的能力|人事
人緣兒|人事
人緣好|好相與
人老珠黃|老藕
人聲沸騰|嘈喧巴閉
人聲鼎沸|含含聲
人能力差|第九
人行道|行人路
人討厭|神憎鬼厭
人販子|拐子佬
人身上的泥垢|老泥
人躲車|避車
人造冰|生雪
人造革外衣|皮褸
人際關係|薄面
人類渣滓|人渣
人高馬大|牛高馬大
什錦|雜錦
什麼不願做|十指孖埋
什麼|乜
什麼"|乜嘢
什麼也不會做|十指孖埋
什麼也不知道|烏龍
什麼人|乜誰
什麼？|咩？
什麼時候|幾時
什麼都只懂一點|周身刀冇張利
仇怨|仇口
仇恨|仇口
仇隙|過節
今天|今日
今天早上|今朝
今天晚上|今晚
今次|今趟
介意|計帶
介於|介乎
介紹|紹介
介面|界面
仍|仲
仍未|尚未
仍然|仲
仍要|尚要
仔細想一想|想真些
仔細想想|諗落
仔細考慮|恁真
他|佢
他們|佢哋
他媽|屌那媽
他日|他朝
他時|第時
他的電腦|部腦
他這個人|佢份人
仗著蠻橫|靠惡
付定金|落定
付小費|打賞
付帳|埋單
付款台|收銀處
付款|磅水
付賬|找數
付錢|畀錢
代人哭喪的婦女|喊口婆
代價大|重皮
代稱法術|茅山
代表作|首本
令人倒胃口|飽死
令人厭惡|飽死
令人吃驚|得人驚
令人|得人
令人憎惡|乞人憎
令人摸不著頭腦|冇厘頭
令人討厭|犯眾憎
令人費解|𢱑穿頭
令人開胃|醒胃
令人難以忍受|惡頂
令人難以理解|冇解
令人驚懼|得人驚
令得|令到
令眾人憎惡|犯眾憎
令箭荷花|霸王花
以上|以上
以下|以下
以件為單位|件頭
以便|至得
以|俾
以假充真|頂包
以免|免至
以八字算命|起八字
以前"|之前
"以前|往時
以前|過氣
以劣換好|偷龍轉鳳
以及|同埋
以少的本錢搏大的利潤|刀仔鋸大樹
以強力|夾硬
以後|到時
以次充好|頂包
以水慢慢滲入|飲
以為|諗住
以牙還牙|你做初一我做十五
以物換物|以物交物
以眼神傳遞感情|丟眼角
以眼還眼|你做初一我做十五
以至|去到
以舌舔唇|斂
以色相佈局行騙|天仙局
以點數決勝負|玩點數
仰起頭來|仰高頭
仰面朝天|反仰
仰面而跌|反仰掉
仰首|昂頭
仲介費|佣
仲裁者|公證
件兒|件頭
件|單
任人宰割的人|羊牯
任何事|咩事
任何式樣|乜花款
任何時候|幾時
任何時間|分分鐘
任公職者|鐵飯碗
任性而刁鉆|刁蠻
任意球|自由球
任憑|任
任由|由得
任隨|隨得
份內該做|應份
份|賣
仿冒品|水貨
企圖|意圖
企盼|望
伊斯坦堡|伊斯坦布爾
伏|褸
伏輸|執輸
伐|倒
休假|唞工
休士頓|休斯敦
休息一下|唞下
休息一回|回氣
休息休息|充充電
休息|歇
休書|分書
伙伴|拍檔
伙同|幫埋
伙計|伙記
伯伯|阿伯
伯明罕|伯明翰
伯母|伯娘
伯父之妻|阿嬸
伯父|阿伯
估衣|故衣
估計|估
估計到|批中
估量|因
伴娘服|姊妹裙
伴進|撈埋
伴郎|戥穿石
伴飯吃|送飯
伴飯|撈飯
伶牙俐齒|牙尖嘴利
伸出|凸
伸手|攤大手板
伸腿兒了|瓜直
伸腿兒|瓜柴
伸長手去取|摮
伺機|候
伺機漁利|博
似乎|好似
似傻非傻|面懵心精
似模似樣|係威係勢
似膠水的性質|黏
但是|但
位子|位
位置|地步
低一級|差一皮
低估|睇小
低低|耷耷
低劣的計策|屎坑計
低劣的辦法|屎坑計
低於周圍|凹
低水平|低位
低矮|翳
低聲細語|陰聲細氣
低聲說話|哆
低能兒|低能兒童
低著腦袋|頭耷耷
低著頭|頭耷耷
低速|低波
低面值紙幣|碎紙
低頭|耷頭
住口|停口
住商兩用|商住兩用
住嘴|收聲
住在一起|住埋
住宅|竇口
住家傳真|家用傳真
住家地址|住址
住家電話|家用電話
住得寬敞|他佻
住手|收手
住聲|收聲
住進|入住
住醫院治療|留醫
住院|入咗醫院
住院治療|留醫
住院進行大手術|入廠大修
佐食|送
佐餐|送
佔不了便宜|咬唔入
佔位|𤗈位
佔位子|霸位
佔位置|霸位
佔便便宜|索油
佔便宜|抽水
佔地方多|壓碇
佔地方|掗埞
佔好位子|霸靚位
佔據|御
佔有|擸
佔|着
佔着毛坑不拉屎|生人霸死地
佔着茅坑兒不拉屎|生人霸死地
何必|使乜
何時何日|幾時幾日
何時|幾時
何等|幾咁
何苦|何嚟
何苦來|自乜嚟由
何處|邊處
佛和某些神|菩薩
佛寺|齋堂
作主|話事
作伴|做伴
作假|裝假笱
作兩手準備|兩睇
作夢|發夢
作孽|折墮
作弄你|整鬼你
作弄|整蠱
作弊|偷步
作弊紙|貓紙
作態|作狀
作案記錄|案底
作業|家課
作業系統|操作系統
作正選|擔正
作法|使法
作白日夢|發白日夢
作罷|罷就
作聲|出聲
作補償|補數
作証|指證
作證|頂證
作賊|做賊
作風不踏實|唔夠飣
作風洋化|鬼聲鬼氣
作飯|煮飯
你一言我一語|你一句我一句
你們|你哋
你們這群|你班
你當然想啦|你就想
你的電腦|部腦
你真行|保你大
佣人|工人
佩槍|馱槍
佯做|詐假意
佯裝愚蠢|扮豬食老虎
佯裝|詐
併桌|搭枱
佻皮|百厭
使上當受騙|搵笨
使不成功|劃涴
使丟臉|落面
使並排|拍
使乾涸|乾
使人上當|搵丁
使人丟臉|甩鬚
使人冷|凍
使人吃驚|得人驚
使人|得人
使人心中氣悶|翳
使人惡心|唔開胃
使人感到滿足|埋腩
使人沾光|帶挈
使人注目|起眼
使人生氣|激
使人當眾出醜|剃眼眉
使人發笑的事|笑話
使人笑話|笑話
使人精神爽快|爽神
使人肉麻|肉酸
使人討厭|腥悶
使人難堪|為難
使|令到
使其大小便|勒
使出見不得人的手段|出術
使出詭計|出術
使出醜|落面
使勁兒|猛咁
使勁摁|扤
使勁踢|省
使受冤枉|冤戾
使受委屈|屈
使受惠|益
使受痛苦|難為
使喚|差使
使圈套|裝彈弓
使彎|屈
使彎曲|彎
使得|令到
使得益|益
使得身上很爽快|爽身
使性子|使頸
使服帖|制掂
使沉默|笠住口
使法術|使法
使清醒|醒
使火力減弱|收慢火
使生氣|吹
使用|用
使用者|用家
使盡法寶|出盡八寶
使盡渾身解數|出盡八寶
使眼色|打眼色
使知道|通
使絆子|起後腳
使羞|醜
使興旺|旺
使通暢|通
使靠近|拍
使順從|制掂
使鬆|鬆
侄兒|侄仔
侄兒媳婦|侄婦
侄子|侄仔
來不及|趕唔切
來世投胎|下世投胎
來人哪|人嚟
來來去去|行開行埋
來到|入嚟
來回走動|遯
來年|下年
來得及|得撤
來得早不如來得巧|遲嚟先上岸
來源|源頭
來臨|嚟緊
來自哪裡？|係邊度嚟㗎？
來自香港的人|港客
來蘇水的俗稱|臭水
來路|乜頭乜路
來電|打入
侍應生|企堂
侍者|企堂
供不應求|渴市
供神小閣樓|神樓
供神的位置|神位
供過神的豬肉|神福
供香|裝香
依我說|計我話
依據|理據
依樣畫葫蘆|照板煮碗
依然|照
依照|照依
依靠|傍身
侮辱|糟騭
侵吞財物|落膈
侷促|怫㥜
便利|利便
便利商店|便利店
便坑|屎坑
便宜|平
便宜很多|平一大截
便宜街坊|益街坊
便宜貨|夜冷貨
便服|街頭服
便當|飯盒
便秘|屙羊咩屎
便衣偵探|雜差
便衣警察|雜差
便衣|雜差
便道兒|行人路
係數|系數
俄式番茄湯|羅宋湯
俊|好睇
俊男美女|型男索女
俊男|靚仔
俗例|事例
俗氣|俗品
俗話說|開講有話
保佑|庇佑
保全|看更
保姆|工人
保守|密實
保安隊員|保安仔
保持原來味道|原汁原味
保持在高位|高企
保持在高水平|高企
保留|保存
保留給|留返
保證|包
保險刀|鬚刨
保險柜|夾萬
保險桿|泵把
保險櫃|夾萬
保險|穩陣
保險箱|夾萬
保險絲|表士
保麗龍|發泡膠
信任|信晒
信佛修行|食齋
信口開合|下爬輕輕
信口開河|爆響口
信息|資訊
信服|服
信瓤兒|信肉
信用|口齒
信用片|財神咭
信紙|信肉
信誓旦旦|實牙實齒
信賴|靠
修圖|執相
修理|整
修理渠道|通渠佬
修補屋頂|葺漏
修車廠|車房
修車|整車
修飾妝容|補妝
修飾|扮靚
俯下|烏低
俯臥撐|掌上壓
俾使|俾
倉庫裝得極滿|爆倉
倉庫|貨倉
個人淺見|粉牌字
個人演唱|個唱
個人的秘密|私隱
個人資訊|個人資料
個兒大|大隻
個兒小|細個
個夠|餐勁
個子大|大隻
個子小的人|豆丁
個子小|細粒
個子極小|一粒骰噉
個子高大|神高神大
個子高的人|高腳鷯哥
個子高高|高高地
個小時|粒鐘
個頭兒|個頭
個頭兒大|大隻
們|
倒下|跌低
倒亂|搞搞震
倒仰兒|反仰掉
倒仰|反仰掉
倒口牙|地包天
倒垃圾|拂垃圾
倒塌|冧
倒扣|仆轉
倒|掟
倒撒了|倒瀉
倒數第一|屘屎
倒數第二|尾二
倒是|話
倒杯茶|斟杯茶
倒楣事情|濕滯
倒楣到家了|黑過墨斗
倒楣|該猥
倒水|斟水
倒牙|牙軟
倒胃|唔開胃
倒蓋|扱
倒行|打倒褪
倒貼|貼
倒賣分子|炒友
倒賣房產|炒業
倒車|褪車
倒退|倒褪
倒運|運滯
倒過來|掉轉頭
倒酒|斟酒
倒閉|執笠
倒霉樣兒|衰樣
倒霉的命運|爛命
倒霉的是|好衰唔衰
倒霉蛋|衰神
倒霉貌|冤口冤面
倒霉起來就總是倒霉|衰開嚟有頭有路
倒霉鬼|衰人
倒騰買賣|炒
倒齒兒|地包天
倔強|硬頸
倔强|硬弸弸
倔|牛精
倚仗|靠
倚站著|半企半挨
倚老賣老|恃老賣老
倚靠|挨凭
借債人|債仔
借光|借借
借機會|借機
借款|度水
借用其他公司|借殼
借花獻佛|借花敬佛
借過|借借
借錢不還|賴賬
借錢|度水
倭瓜|番瓜
值夜班|睇更
值得|抵
值得看|睇得過
值得考慮之處|諗頭
值得考慮|諗得過
值當|物有所值
值錢|起市
假冒|讕
假如|假若
假客氣|讕客氣
假山|假石山
假山石|假石山
假扮|扮
假摔|插水
假日|紅日
假正經|讕正經
假洋鬼子|半唐番
假消息|流料
假的|詐
假的車牌|假牌
假裝|假扮
假裝友善|扮好人
假裝排場|讕架勢
假裝正經|讕正經
假裝糊塗|詐傻
假貨|流嘢
假面具|笑面
偏偏|硬係
偏僻地方|背角
偏僻|山旯旮
偏口魚|笪沙魚
偏好|鍾意
偏房|妾侍
偏袒|爭住
偏遠|隔涉
偏食|偏蝕
做上你的飯|煮重米
做不三不四的事|做鬼做馬
做不到的事|死綟
做不好|攪唔掂
做不成|整鬼整馬
做不正當的營生|行斜路
做事不依次序|倒褪
做事不像話|唔係路
做事不利|離氣
做事不到家|唔到位
做事不貫徹|冇尾飛陀
做事不馬虎|企理
做事到家|到位
做事情|做工夫
做事情有恒心|神心
做事極為保險|絡住囉柚吊頸
做事無計劃|離氣
做事缺後勁|耷尾
做事虎頭蛇尾|耷尾
做事貪圖省力|諗縮數
做事順利|得意
做事馬虎|哩哩啦啦
做人圓滑|豆腐刀
做人窩囊|冇料
做什麼|做乜
做作|作狀
做使人受害的事|靠害
做保姆|打住家工
做到|得
做功|做手
做危險的事|唔要命
做善事|修橋整路
做善後|手尾
做夜宵|宵夜
做夢|發夢
做夢都想不到|發夢都諗唔到
做大鍋飯|開大鑊飯
做女傭|打住家工
做女紅|做針黹
做好|搞掂
做好準備|預
做完|做埋
做家具|鬥家私
做小鍋飯|煮飯仔
做工人|打工
做工|做手
做幾|整幾
做廣告|賣告白
做得不對|行差踏錯
做得|整得
做得罪人的事|做醜人
做怪|作怪
做慣|搞開
做手腳|出貓
做投機生意|炒賣
做掌櫃|做收錢
做探親用的禮物|做手信
做收尾工作|執手尾
做木匠活|鬥木
做木工活兒|鬥木
做木工|鬥木
做機關捉雀類|裝雀
做法事|打齋
做派|做手
做為補償|補數
做無米之炊|煲冇米粥
做熟|搞開
做牛馬|做驢仔
做甚麼也白搭|乜都假
做甚麼|搞邊科
做白日夢|發白日夢
做白臉兒|做醜人
做百天|做百囉
做空頭生意|炒買炒賣
做聲|聲
做肥料的水|肥水
做菜|煮菜
做衣服|度身
做表面工夫|整色整水
做被用的大針|絎針
做討人高興的事|做好人
做警察|當差
做針線活兒|做針黹
做錯事|行差踏錯
做錯|搞橫
做開|搞開
做雜活的工人|細工
做頭|擔認
做飯吃|煮食
做飯|煮食
做鬼臉|整鬼面
停下來|停定
停下|停低
停口|閘住
停好|停定
停手|忍手
停放|泊
停放車輛|泊車
停業|閂鋪
停歇|歇手
停止營業|收檔
停止說話|收口
停止|閘住
停水|制水
停泊|泊
停當|定當
停車|泊車
停電|制電
停靠|泊
健壯|大隻
健忘|冇耳性
健碩|大份
健談|啱傾
健身房|健身室
側坐|打橫
側寫|個人資料
側着|打橫
側著身子坐|打側坐
側近|側邊
側邊|橫邊
側門|橫門
側面|橫邊
偵察員|探員
偶然|唔覺意
偶然間|耐唔中
偶爾|間中
偶遇|碰
偷人家的雞|偷雞
偷偷地拿走|鼠
偷偷拿走|鼠
偷偷潛入|鼠
偷偷離開|鬆人
偷偷|靜雞雞
偷吃|作怪
偷天換日|偷龍轉鳳
偷奸取巧|偷步
偷學|偷師
偷巧|偷步
偷情|偷食
偷懶|躲懶
偷拍|偷影
偷東西|高買
偷梁換柱|偷龍轉鳳
偷渡出境|較腳
偷渡|屈蛇
偷渡的少年兒童|小人蛇
偷渡者|人蛇
偷皮夾|打荷包
偷看|張
偷竊|高買
偷笑|陰陰笑
偷錢包|打荷包
偷閑|偷雞
偷龍轉鳳|斬雞頭換雞腳
偽劣產品|水貨
偽君子|褸錯人皮
偽裝|裝假笱
傀儡|扯線公仔
傍晚兒|俟晚
傍晚|挨晚
傘枝|遮骨
傘桿兒的尖端|遮柄
傘的骨架|遮骨
傘|遮
備用|睇門口
備齊|整晒
傢伙|條友
傢俱|傢俬
催促|刮
催命似|趕喉趕命
催命鬼|催命符
催新娘上轎|催妝
催逼|催
傭人|家傭
傲慢|高竇
傳出|爆出
傳喚|傳呼
傳小抄|通水
傳授方法|教路
傳授經驗|教路
傳票|花令紙
傳統字|繁體
傳聲器|咪頭
傳遍|傳勻
傳達|通
債務人|債仔
債戶|債仔
傷亡慘重|一頸血
傷口痊癒|埋口
傷口癒合|埋口
傷害|損
傷心|傷感
傷氣|破氣
傷腦筋|想壞腦
傷身體|破氣
傻乎乎|癲癲廢廢
傻了眼|眼定定
傻冒|傻仔
傻勁兒|蠻力
傻呵呵|傻傻更更
傻大個兒|高大衰
傻子|阿傻
傻小子|傻仔
傻愣愣|傻戇戇
傻瓜|傻人
傻瓜才理睬他|睬佢都傻
傻里傻氣|戇居居
傻頭傻腦|傻傻更更
傻頭傻腦的人|阿茂
傾倒|倒瀉
傾盡全力|搏到盡
傾|談
僅僅夠|舋舋莫莫
僅僅|淨
僅有的本事|三板斧
僅|淨只
僅足以活命|吊鹽水
像個樣子|有型有款
像哭的樣子|喊噉口
像它|同佢相似
像是|好似
像極了|似足
像模像樣|似模似樣
像樣|有型
像泥一樣|蓉
像狗一樣|一隻狗噉
像男孩的女孩子|牛王妹
像的|似
像苦瓜乾般的嘴臉|苦瓜乾噉口面
像話|似樣
像豬一樣蠢的人|豬嘜
像鬍鬚之物|鬚
像鳥一樣|一隻雀噉
僑匯|鹹水
僥倖|博彩
僧多粥少|手快有手慢冇
僭越|讕
僱工|打工仔
僱殺手殺人|買起
僵直不能動|瘸
價格下跌|跌價
價格|價位
價格很硬|揸價
價目表|價錢牌
價錢公道|老實
價高|起市
儀容態度|格局
儀態嬌貴|貴氣
儉省|慳儉
儍乎乎|戇瞿瞿
儍子|儍仔
儍|戇
儍瓜|儍佬
儍眼|眼眢
儍里儍氣|壽頭壽腦
儘管|即管
償命|賠命
優哉游哉|他條
優|堅
優待|益
優惠|着數
優格|乳酪
優游|滋游
優良|堅
優質紅糖|冰片糖
優質芒果|呂宋芒
優酪乳|乳酪
儲存|保存
儲|措
儲物櫃|櫃桶
儲物間|士多房
儲藏室|士多房
儲錢的罐子|錢罌
儲錢罐|錢罌
允許|應承
允諾|應承
元件|組件
元宵|湯丸
元旦|新曆年
元配|大婆
兄弟登山|田雞過河
兄弟|細佬
兄長|大佬
兄|阿哥
充值|增值
充其量|至多唔係
充其量還不是|最多唔係
充愣|扮傻
充排場|讕架勢
充數|頂檔
充當|做
充當反對者|做醜
充耳不聞|畫耳埋牆
充|讕
充闊氣|充大頭鬼
充電|叉電
充飢|頂肚餓
充饑|頂肚
兆頭|腳頭
兇巴巴|惡揗揗
兇悍|惡形惡相
兇惡|惡死睖覴
兇橫者|橫紋柴
兇狠惡毒|番鬼
兇狠|狼胎
先人|老祖
先|住
先別|勿住
先前|頭先
先回去|返去先
先坐一會兒|坐下先
先坐下|坐下先
先射進|先入
先生|生
"先生|阿生
先買了|買定
先走|行先
先這樣吧|係噉先喇
先頭|先時
先頭兒|頭先
光亮|光猛
光亮耀眼|光振振
光天化日之下|日光日白
光天化日|日光日白
光彩|體面
光怪陸離|冇情白事
光明正大|行得正企得正
光是|淨係
光桿兒一個|一枝公
光棍兒|單身寡佬
光棍|寡佬
光|清光
光溜溜|光捋捋
光滑|滑
光禿禿|光禿碌
光綫刺目|掁眼
光線充足|光猛
光腳丫子|打大赤腳
光腳丫|打赤腳
光腳|打大赤腳
光膀子|打大赤肋
光膊子|打大赤肋
光著腳|打赤腳
光著膀子|打赤肋
光說不做|冇腰骨
光說不幹|講得口響
光靠一把口|得個講字
光顧|幫襯
光麵|淨麵
克羅埃西亞|克羅地亞
兌|兑
兌子|鬥棋
兌換|找換
免得|謹防
兒大不由娘|仔大仔世界
兒女|仔女
兒女們|班仔女
兒女都大了|仔大女大
兒媳婦|新婦
兒媳|新婦
兒子|個仔
兒戲|兒嬉
兒童不宜觀看的電影|成人電影
兒童|少兒
兒童組成的犯罪幫伙|童黨
兔兒唇|崩口
兔唇|崩口
兔寶寶|兔仔仔
兔崽子|衰仔
兜一圈兒又回來|打白鴿轉
兜了個大圈兒|行大運
兜兒|袋
兜底|爆大鑊
兜|插手袋
兜攬|兜搭
入不敷出|唔夠皮
入夢|搵周公
入屋偷竊|爆 竊
入屋盜竊|爆竊
入席|埋席
入座|埋位
入座率高|收得
入手|埋手
入時|趨時
入窩|埋籠
入迷|暈浪
入選|入圍
內地|上便
內奸|內鬼
內定|造馬
內幕消息|貼士
內幕被泄漏|穿煲
內建|內置
內心|心地
內心愉快|心甜
內情|首尾
內掌櫃|事頭婆
內插法|插值法
內斜視|鬥雞眼
內河航行渡船|拖渡
內燃機火花塞|火嘴
內用|堂食
內行人|行家
內行|在行
內衣|底衫
內褲|底褲
內進|入內
內部吃扒外的人|內鬼
內部的空腔與外部不通|密籠
內部空|空籠
內部|裏
內鬥|鬼打鬼
內鬨|鬼打鬼
內鬼|內宄
全亂了套|亂晒坑
全亂套了|亂晒大籠
全|冚
全力支持者|忠實擁躉
全包了|一腳踢
全合乎禮儀|禮儀周周
全因為|皆因
全在|喺晒
全坐滿了人|爆棚
全家人|一家大細
全家死光|冚家鏟
全年|周年
全按規矩辦事|依足規矩
全新|新簇簇
全是|淨係
全是紅字|滿江紅
全沒有了|清光
全滅|冚家剷
全滿|頂籠
全班|一班
全班合照|班相
全當作主|打晒色
全盤失敗|一鑊熟
全盤皆失|臨天光瀨尿
全盤皆輸|一戙都冇
全神貫注|足晒用神
全自動汽車|自動波
全螢幕|大板度
全身|周身
全身上下|周身
全身疼痛|周身痛
全身酸痛|周身痛
全速行駛|開晒車
全選|揀晒
全部不及格|滿江紅
"全部|冚
全部|冚不論
全部失敗|玩完
全部承包辦理|包斬包鍘
全部"|晒
全部沒有了|清光
全部的人|成班人
全部置換|換晒
全部選取|揀晒
全都|冚
全都怪|一日都係
全都死光|一鑊熟
全靠|靠晒
全食|全蝕
兩下|兩嘢
兩不相下|鬥負氣
兩世為人|死過返生
兩人同睡一床|孖鋪
兩人散伙|一拍兩散
兩伙人|兩路人馬
兩刻鐘|兩個骨
兩千|二千
兩可|是但
兩天|兩日
兩手準備|兩睇
兩撇鬍兒|二撇雞
兩撇鬍子|二撇雞
兩毛|二毫
兩物之間的間隙|罅
兩球|兩粒
兩百|二百
兩眉之間|眉心
兩眼發直|眼定定
兩種可能|兩睇
兩端|兩便
兩端對齊|齊頭齊尾
兩耳搧風|兜風耳
兩腿之間|髀罅
兩腿跨坐|騎
兩萬|二萬
兩角|兩毫
兩邊不討好|順得哥情失嫂意
兩邊|兩便
兩面三刀的人|屎窟鬼
兩面|兩便
兩面受氣|挨夾棍
兩面耍滑頭的人|兩頭蛇
兩頭受氣的人|夾心餅
兩頭落空|兩頭唔到岸
兩頭行|兩頭走
兩點整|沓正兩點
八九不離十|七七八八
八卦妹|八妹
八卦婆|八婆
八哥|了哥
八哥兒|鷯哥
八婆|八卦婆
八字還沒一撇|十畫未有一撇
八字鬍子|兩撇鬚
八帶魚|八爪魚
八月節|中秋節
八角茴香|八角
八點整|沓正八點
公公|家公
公共汽車|巴士
公共的大水管|街喉
公分|厘米
公家|阿公
公尺|米
公布|公佈
公文包|公事包
公曆元旦|新曆年
公款|公帑
公正|君真
公正嚴謹|均真
公然|明火
公然欺負|明剃眼眉
公牛|牛公
公狗|狗公
公用水龍頭|街喉
公眾的信任|公信力
公私分明|均真
公羊|羊牯
公豬|豬公
公貓|貓公
公車|巴士
公道|均真
公鑰|公開密碼匙
公開化|地面化
公開|明
公開謎底|開估
公開講明態度|開明車馬
公開透露|大爆
公雞|雞公
六神無主|失驚冇神
六親不認|斷六親
六點整|沓正六點
共亨甜頭|分甘同味
共享甜頭|分甘同味
共同|兩份
共同策劃|佮計
共同設法|佮計
共|孖
兵來將擋|見招拆招
其他時候|第日
其他|第啲
其實|查實
具備|穩陣
典型人物|人辦
典當行|大押
兹|茲
兼差|炒更
再三思考|諗嚟度去
再不怕|再唔慌
再不濟也|衰衰地
再來|至嚟
再加上|計埋
再多|多多的
再婚女人|翻頭婆
再婚|翻頭嫁
再嫁|翻頭嫁
再生|翻抄
再看|看多
再給|畀過
再聊|傾過
再見|拜拜
再試一次|試多次
再試試看|又試
再試|試過
再說|再算
再講一遍|講多次
再買|買過
再醮婦女|紅屐仔
再醮婦|返頭婆
再重新啟動|開返過
冒充|頂檔
冒冒失失|失魂
冒名頂替|頂包
冒失|擒青
冒失鬼|失魂魚
冒|標
冒汗|滮汗
冒火兒|火起
冒險|博
冗|宂
冤仇|仇口
冤屈|屈
冤枉|冤戾
冥鈔|陰司紙
冬天|天時冷
冬至|冬
冰|凍
冰凍|雪
冰原|冰海
冰棍兒|雪條
冰棍形的冰淇淋|雪批
冰棍狀的冰淇淋|雪糕批
冰棍|雪條
冰棒|雪條
冰水|雪水
冰涼|凍冰冰
冰淇淋工廠|雪糕廠
冰淇淋|雪糕
冰箱的冷凍箱|冰格
冰箱|雪櫃
冰花|雪茸
冰鎮|雪藏
冰雹|鑿
冷不防|失驚冇神
冷冰冰|凍冰冰
冷冷清清|水靜河飛
冷|凍
冷凍劑|雪種
冷凍豬肉|雪豬肉
冷凍|雪藏
冷天|天時冷
冷巷|陰冷
冷清|靜局
冷藏|雪凍
冷門馬|黑馬
冷開水|凍水
冷靜|老定
冷顫|打冷震
冷颼颼|涼浸浸
冷飲店|冰室
冷飲|涼水
凄涼|慘情
准確地估計到|批中
准頭兒|眼水
凌亂|笠亂
凍兒|凍
凍冰|結冰
凍瘡|蘿蔔仔
凝固|凝
凝結|凝
凝結的豬油|豬膏
凝聚|齊集
凡士林|花士令
凡是|逢嚫
凱子|老親
凶惡得很|惡死能登
凶惡|惡死
凶狠|狼
凹下去的位置|凹位
凹下|癟
凹凸不平|凹凹突突
凹進去|凹
凹陷|凹
出主意|度橋
出乎意外|跌晒眼鏡
出乎意料|鬼頭鬼路
出了大問題|大鑊
出事|有事
出人意外|跌晒眼鏡
出人意料|爆大冷
出來了|咗出嚟
出來做事|做世界
出來|出埋
出入自便|冇掩雞籠
出去|去街
出去工作|出身
出口傷人|唔好口
出口|開聲
出古怪主意|出蠱惑
出名|出晒名
出售|賣
出國旅遊觀光|遊埠
出國|過埠
出大事|大禍
出大事故|大單
出嫁|出門
出岔子|倒米
出差錯|做錯嘢
出廠證|出世紙
出手低|低莊
出手大方|爽手
出手|落手
出手闊綽的有錢人|闊佬
出招子|出招
出故障|神
出於好心辦事|做好心
出殯|出山
出殯時孝子打旛|擔旛
出氣|下啖氣
出氣袋|吹氣袋
出泡沫|起泡
出洋相|甩鬚
出洋|過埠
出清|清貨
出版作品|出書
出版書籍|出書
出版著作|出書
出獄|放監
出現好的勢頭|睇好
出現於鏡頭上|上鏡
出現|浮頭
出現過|浮過頭
出生|出世
出生證|出世紙
出產|出埋
出疹子|出風㫱
出痲疹|出痲
出盡風頭|攞晒彩
出眾|標青
出着兒|出招
出租小汽車|的士
出租車|的士
出籠|開籠
出聲|開聲
出色|叻
出芽|標
出術|出把戲
出街|去街
出診|睇病
出詭計|出把戲
出謀劃策者|文膽
出謎語|打估
出賣了|賣咗豬仔
出賣勞力|賣豬仔
出賣|賣豬仔
出醜|丟架
出鋒頭|攎彩
出錯|搞橫
出門兒|出街
出門|出門口
出門子|嫁人
出閣|嫁人
出陣|上馬
出頭|出面
出類拔萃|標青
出風頭|出位
出馬|上馬
出麻疹|出麻
出點子|教路
函式|函數
刀子|刀仔
刀尖|刀嘴
刀鞘|刀殼
刁橫|刁僑扭擰
刁蠻|扭計
刁蠻造作|刁喬扭擰
刁鑽|招積
刃|口
分一杯羹|分到餅仔
分不清好壞|跌眼鏡
分享心事|講心事
分作兩份|兩份
分割|斬開
分娩|蘇
分寸|度數
分岔路|分叉路
分幣|仙屎
分店|分局
分成兩段|斷
分手|甩拖
分散各處|東支西散
分明|擺明
分析及解說|拆
分派學位|派位
分派|派畀
分派給|批畀
分發|派發
分發獎金|派彩
分送|派
分道揚鑣|你東我西
分配到|派入
分配|派
分量重|重秤
分開|擘開
分離|離
分項目|條
分頭|西裝
分頭走|散水
切中要害|到位
切脈|探脈
切|起
切身問題|貼身問題
刑警|雜差
划不來|冇數為
划子|艇仔
划得來|為得過
划|扒
划算|䎺得過
划船|扒艇
划龍舟|扒龍舟
划龍船|扒龍舟
列印|打印
列支敦斯登|列支敦士登
列|迾
初來乍到|初嚟甫到
初出殼的小雞|雞花
初出殼的小鵝|鵝花
初學開車的人|學神
初次|頭威頭勢
初階者|初哥
判斷失誤|唔夠眼
判若二人|差天共地
判若天淵|差天共地
判若雲泥|差天共地
別人|人哋
別人的隻言片語|口水尾
別人說過的話|口水溦
別傻|傻啦
別再幹了|收檔
別名|花名
別吵|收聲
別客氣|唔使唔該
別忘了|勿唔記得
別想了|唔使欿
別想|勿諗
別慌|唔使慌
別扭|兩句
別扭過臉去|擰歪面
別把|勿將
別指望了！|早唞喇！
別指望|勿冀望
別提|勿提
別提啦|唔使計
別浪費|勿嘥
別痴心妄想|唔使指擬
別的|另外
別的地方|第度
別緻|趣緻
別若天淵|爭天共地
別若霄壤|爭天共地
別著急|唔使緊
別處|第度
別說|勿話
別這麼說|唔係噉話
別針|扣針
刨冰|雪茸
利字當前|利字當頭
利害|交關
利害到家了|大晒
利害的人|老薑
利息|息
利欲熏心|利字當頭
利潤|出息
利潤很少|微
利率|息口
利用|過橋
利用電腦抽簽|攪珠
利益|油水
利索|爽手
刪除|刪清
刮|刮削
刮地皮|刮龍
刮臉刀|鬚刨
刮臉|剃面
刮風下雨|打風打雨
刮風|打風
刮颱風|打風
刮鬍刀|鬚刨
刮鬍子|剃鬚
到不了|有找
到別人家寄食|掛單
到去|出
到國外去|食鹹水
到外地過年|避年
到娛樂場所玩樂的人|蒲友
到家|過骨
到底|終之
到手|得食
到旮旯角去找|蜎窿蜎罅
到時候|到時
到時見|約定你
到時間了|夠鐘
到時間|夠鐘
到最後|臨尾
到期|夠鐘
到海中|出海
到海外|出埠
到無與倫比|到冇倫
到盡頭|頂籠
到碼頭接人|接船
到站|埋站
到處|周圍
到處亂摸|摸身摸勢
到處向人行騙|呃神騙鬼
到處找|打鑼噉搵
到處流浪|浪蕩流離
到處籌款|撲水
到處說人壞話|唱衰
到處走動|走埠
到街上|去街
到車站接人|接車
到過|去過
到達|到埞
到達目的地|到位
到那個時候|到其時
到醫院門診部看病|睇街症
到鐘點|夠鐘
到預定時候|夠鐘
到飛機場接人|接機
到點|夠鐘
制伏|治
制動系統|迫力
制服人|收人
制服|制掂
制約|綁
制錢|碎錢
刷帚|掃
刷|擦
刷牆|髹灰水
刺傷|拮傷
刺兒頭|招積
刺到|戛到
刺喉嚨|戟喉
刺激|戳
刺激鼻子|攻鼻
刺痛|針拮
刺目|光振振
刺眼|晟眼
刺鼻|攻鼻
刻薄地對待|糟質
剁|斫
剃光頭髮|剃光頭
剃胎毛|剃臊毛
剃頭|飛髮
削|𠜱
削價出售的貨|跳樓貨
削減開支|縮皮
削絲瓜皮的工具|絲瓜刨
削肩|美人肩
削薄|偷薄
剌中|插中
剌|刉
前一段時間|早排
前一輩子沒積德|前世唔修
前一陣子|前個排
前些日子|早排
前些時候|先一牌
前仆後繼|一仆一碌
前功盡棄|前功盡廢
前半晌|上半晝
前半晌兒|上晝
前天|前日
前天晚上|前晚
前幾天|近日
前往|去
前往"|去向
前後合共|頭尾夾埋
前後|頭尾
前晌兒|上晝
前襟|衫帔
前進|進前
前邊兒|前便
前邊|前便
前院兒|前園
前面|前便
前頭|前便
前額|額頭
剎不住|冇制
剎車失靈|冇制
剎車|煞掣
剎車裝置|制
剎那間|一時間
剔去|辟
剔去骨頭|起骨
剔手旁兒|剔手邊
剔除|剔
剖開肚子|劏肚
剛來到不久|初嚟甫到
剛出新芽|爆芽
剛出殼的小鴨|鴨苗
剛剛出爐|新鮮滾熱辣
剛剛到|初嚟甫到
剛剛|啱啱
剛剛推出|新鮮滾熱辣
剛好|剛剛好
剛好碰上|撞正
剛才|啱先
剛烈|火爆
剛睡醒的樣子|矇忪
剛結婚的女人|新嫁娘
剛考獲車牌的人|新牌仔
剛開始|初時
剝刮大筆錢財|刮粗龍
剝刮錢財|刮龍
剝削|刮削
剝|搣
剝皮魚|剝皮牛
剝開|皽開
剩下|剩低
剩下的事|手尾
剩下的活兒|手尾
剩下的食物|食剩
剩菜裏的湯水|菜汁
剩菜|酒腳
剩貨|籮底橙
剩飯|冷飯
剩飯底子|飯腳
剩餘物|腳
剪下|剪切
剪刀|鉸剪
剪子|鉸剪
剪接|剪片
剪票口|閘
剪薄|偷薄
剪裁布料|剪布
剪頭髮|剃頭
副食店|雜貨鋪
割稻子|割禾
割開|劏開
割鬍子|剃鬚
創意|新意思
創辦人|攪手
剷垃圾的鐵鍬|垃圾鏟
劃分|劃
劃清界線|割蓆
劃破|劖
劃算|上算
劇情簡介|戲橋
劇情結構|橋段
劈叉|擘一字
劈柴|破柴
劈里啪啦|霹靂拍勒
劑|服
力巴兒|外行
力度|力水
力氣|力
力氣大|大力
力求|搏
力量|力水
功成名就|名成利就
功敗垂成|鯁頸
加一成收費|加一
加一服務費|加一
加上一|加多
加上|加埋
加倍|耷保
加入|添加
加塞兒|打櫼
加夜班|炒更
加工|炮製
加工資|加人工
加強注意|醒神
加彭|加蓬
加意收拾|輯正
加水|浸水
加油|入油
加油！|加油！
加熱|焮返
加班費|補水
加盛飯|添飯
加租|起租
加|落
加薪水|加人工
加薪金|加人工
加起來|加埋
加速達到要求|惡補
加進去|加插
劣等貨|渣嘢
劣|苴斗
劣貨|籮底橙
劣質貨的俗稱|流嘢
劣質酒|土炮
助勢|打鼓邊
助手|二手
助理|後生
努力|勤力
努著勁兒|鼓住道氣
劫匪|賊人
勁射|抽射
勇敢|勇武
勉強下咽|骾
勉強夠數|敹口
勉強|夾硬
勉強過得去|麻麻哋
勉強還可以|麻麻
勉為其難|死死氣
勒|𦂗
勒索|索
勒緊|索
勒脖子|箍頸
動一下|喐下
動一動|喐下
動不動|喐唔喐
動了邪念|起心
動作保持|嚮度
動作快|啦啦聲
動作慢|咪咪摸摸
動作|搞作
動作要快|手快有、手慢就冇
動作遲鈍|木獨
動作頻仍|搞作多多
動來動去|㤢身㤢勢
動彈|岌岌貢
動心|心郁郁
動手做活兒|開工
動手做飯|煮食
動手動腳|㤢手㤢腳
動手術|開刀
動搖不定|發軟蹄
動搖貌|扤扤搖
動物交配|打種
動物做窩|搭竇
動物的小腸|粉腸
動物的膽囊|膽
動物的雄勢|鞭
動畫|卡通
動畫片|卡通片
動筷子|起筷
動粗|講打講殺
動腦筋|食腦
動身|起錨
動輒|閒閒地
動靜|異喐
務必追及|追瘦
務農|耕田
勛章|荷蘭水蓋
勝算|贏面
勝|贏
勞動階層|打工仔
勞|唔該
勞心|嘥心機
勞煩了|勞煩晒
勞碌奔波|頻撲
勞神|勞氣
勞若無人|大模斯樣
勞苦受累者|驢仔
勞苦謀生|捱騾仔
勞駕|唔該
勞鴐|借過
勢利小人|白鴿眼
勢利眼|白鴿眼
勢力|勢
勢力範圍|地頭
勢必|實行
勢必想不到|勢想不到
勢焰萬丈|財雄勢大
勢頭|勢色
勢頭大|大陣仗
勤勞|勤力
勤奮|勤力
勤快|勤力
勤謹|勤力
勳章|荷蘭水蓋
勸架|勸交
勸解|開解
勸說不已|媕
勺子|匙羹
勺|殼
勻|勻洵
勻和|勻
勾引男人|勾佬
勾心鬥角|狗咬狗骨
勾芡|打芡
勾選|打交叉
包下|包起
包不包括|包唔包
包乾兒|全包宴
包含在內|有埋
包含|埋
包|奉旨
包工頭|判頭
包幹|一腳踢
包幹兒|一腳踢
包括|埋
包捲|斂
包攪|一腳踢
包攬一切|一腳踢
包攬|一腳踢
包攬事務的人|攬頭
包月人力車|長班車
包月|長班車
包穀|粟米
包縫兒|鈒骨
包羅萬象|包羅萬有
包菜|椰菜
包著|包住
包袱沉重|一搊二掕
包辦的婚姻|盲婚
包邊兒機|鈒骨機
匆匆忙忙|擒青
匆匆|滾水淥腳
匆忙而狼狽|離氣
匆忙|頻蹸
化凍|雪融
化妝|扮鬼扮馬
化子|乞兒
化學電池|電芯
化雪|雪融
北方人|北佬
北方佬|北佬
北方石榴|結子石榴
北美洲|金山
匙子|匙羹
匪徒|賊人
匯款|過數
匯票|匯單
匯費的舊稱|匯水
匹配|夾
區別|分別
區區|小小的
十一點整|沓正十一點
十二點整|沓正十二點
十五分鐘|三個字
十來天時間|一頭半個月
十個指頭有長短|十隻手指有長短
十元|粒神
十分像|十足十
十分嬌貴|身嬌肉貴
十分容易|話咁易
十分生氣|激奀
十分相像|似足
十分|真係
十分聰慧|好惺
十分贊成|舉腳贊成
十分鐘|兩個字
十問九不答|十問九唔應
十多款|十幾款
十字鎬|十字鋤
十幾種|十幾款
十拿九穩|十成着九成
十整|十齊頭
十有九得|十成着九成
十有八九|十居其九
十根手指有長短|十隻手指有長短
十足|正一
十里|塘
十點整|沓正十點
千元|千
千方百計地躲避|避債咁避
千瓦時計|電表
千真萬確|實牙實齒
千萬|千祈
千辛萬苦地生活|挨生挨死
千里達|特立尼達
千鈞一髮|險過剃頭
升旗|撦旗
升火|透火
升級|升職
升職|扎職
午睡|睡午覺
午覺|晏覺
午飯|晏晝飯
半佔半靠|半企半挨
半個月左右|一頭半個月
半半拉拉|半勒卡
半吊子|半桶水
半大小子|男仔頭
半大的豬|豬花
半大的鵝|鵝朴
半天|半晝
半天時間|半晝
半孵化的雞蛋|雞仔蛋
半懂不懂|半桶水
半摟半抱|攬身攬勢
半斤八兩|一擔擔
半晌午|半晝
半死不活|半條命
半死|死死下
半決賽|準決賽
半熟蛋蛋黃|溏心
半瓶醋|半桶水
半角|碎銀
半角錢|斗零
半調子|半桶水
半路|半途中
半透明的橡膠|生膠
半途而廢|冇腰骨
卑劣的手段|哪渣手段
卑劣|藞苴
卑鄙下流|污糟邋遢
卒之|終之
協助|幫埋
協調|咬弦
南方水果|番鬼蒲桃
南洋華僑|南洋客
南瓜|番瓜
南腔北調|半咸淡
占卜算命|起
卡住喉嚨|鯁頸
卡住|棘住
卡|咭
卡死|骾死
卡紙|夾紙
卡達|卡塔爾
印出|顯示
印刷用鉛字|字粒
印地語|印度語
印度人|阿差
印度男人|阿叉
印紙|過底紙
印表機|打印機
危險之至|險過剃頭
危險的樣子|危危乎
即使|就算
即便是|即係
即刻|當堂
即將|嚟緊
即活動插座|拖蘇
即甜食|甜品
即興|爆肚
即配電盤|掣板
即鱟魚|海鱟
卵|春
卵石|石春
卷尺|軟尺
卷心菜|椰菜
卷狀粉條|腸粉
卷筆刀|鉛筆刨
卷髮|攣毛
卸妝|落妝
卸膊|落膊
卸貨|落貨
厄利垂亞|厄立特里亞
厄瓜多|厄瓜多爾
厚厚|厚身
厚|厚身
厚實|厚身
厚背心|龜背
厚道|謙厚
原來|原底
原來如此|係喎
原則|正
原原本本|原汁原味
原因|因由
原本|本身
原珠筆|原子筆
原生|親生
原由|頭尾
原籍|鄉下
厭惡|飽
厭煩|煩厭
厲害|犀利
去世|過身
去中心化|冇大台
去了|摸上
去做|搞住
去偷去搶|做世界
去冰|走雪
去到|出到
去哪裡了|去咗邊
去喜宴的衣服|飲衫
去外國|過埠
去大便|去屙屎
去妓院吃酒|開廳
去小便|去屙尿
去年|舊年
去掉|除
去探望過他|去過探佢
去暑氣|清暑
去暑|清暑
去根兒|斷尾
去殼|剝殼
去火|制火
去糖|走甜
去腥味兒|辟魚腥
去除濕氣|去濕
去除|闢走
去除魚的腥味|辟魚腥
去電|打出
去香港謀生|食鹹水
參加了|報了
參加工作|見工
參加進去|浸
參差不齊|好碞磛
參看|睇埋
參考|抄考
參與|埋份
參與番攤的賭博|賭番攤
又便宜又好|平佮正
又做好人、又做壞人|做好做醜
又吸煙又喝酒|又煙又酒
又唱紅臉又唱白臉|做好做醜
又大又粗笨|笨鈍
又快又好|快佮妥
又是裙又是褲|又裙又褲
又有什麼問題|又點話
又白又胖|肥肥白白
又矮又胖的人|戙企水魚
又細又嫩|幼滑
又肥又大|肥肥大大
又胖又大|肥屍大隻
又這個又那個|又乜又物
又這樣又那樣|係乜係物
又酥又脆|卜卜脆
又髒又臭|鹹臭
叉燒肉|叉燒
及格|過骨
及至|至到
友善|好好人
友誼深|老友
反向|倒向
反唇相譏|頂喉頂頸
反復無常|午時花六時變
反復衡量|度
反急|翻草
反悔|反口
反感|眼冤
反應過敏|緊張大師
反正|橫直
反正都是死|橫又係死、掂又係死
反犬旁|犬字邊
反而|反為
反覆考慮|諗諗下
反貼門神|貼錯門神
反過來|倒轉頭
反過來說|掉返轉
反面人物|大奸角
反面|底面
反駁|辯駁
叔伯兄弟|禾杈髀
叔伯|疏堂
叔兒|阿叔
叔叔|阿叔
叔父之妻|阿嬸
叔父|阿叔
叔祖|叔公
叔祖母|叔婆
取出|抽
取名|改名
取回|搦返
取得|攎
取|攎
取決於|視乎
取消|唔做
取物|擙
取藥|執藥
取貨|起貨
取食|啄
受不了|難抵
受人操縱者|扯綫公仔
受傷|損
受僱於人|做臺腳
受冷落|炖冬菇
受冷遇|識貌麵
受凍|抵冷
受凍的樣子|面青口唇白
受到迷惑|着鬼迷
受到|食
受夾板兒氣|挨夾棍
受夾板氣|食夾棍
受害很慘|五顏六色
受屈|慍氣
受得住|抵得
受折磨|磨心
受挫|撞板
受暑|感暑
受歡迎|當紅
受歡迎程度|人氣
受歡迎程度迅速上升|人氣急升
受氣|掬氣
受氣的人|磨心
受涼|攝
受熱|焗親
受用|受落
受益|得益
受聘禮|受茶禮
受苦|折墮
受賄|刮龍
受連累|拖落水
受雇工作|打工
受驚不已|嚇破膽
受驚|嚇窒
叛徒|二五仔
口不對心|講一套做一套
口乾舌燥|口乾
口吃|吃口
口味|口
口多多|口痕友
口大喉嚨小|眼闊肚窄
口巧舌能|口乖
口感|口
口感好|好咬口
口感好而香甜|爽甜
口感很好|好爽口
口才|牙力
口是心非|口唔對心
口氣|啖氣
口氣強硬|口硬
口氣很大|大口氣
口氣軟|口軟軟
口水|嗲
口水巾|口水肩
口沒遮攔|口不擇言
口沫橫飛|口水浪花
口渴|頸渴
口福|食福
口算|口數
口糧|米糧
口紅|口唇膏
口緊|口密
口腹之欲|口癮
口舌是非|成身蟻
口若懸河|口響
口蜜腹劍的人|屎窟鬼
口袋兒|衫袋
口袋|袋
口裏|口中
口角|嘈吵
口角炎|爛口角
口語|白話
口銜物|擔
口音|音底
口香糖|香口膠
口齒不清|食螺螄
口齒伶俐|牙尖嘴利
古古怪怪|鬼五馬六
古怪|奇離
古板|唔化
古柯鹼|可卡因
古老|老爺
古老肉|咕嚕肉
古舊|老舊
古道熱腸|好人事
古靈精怪|鬼馬
另一些|第二啲
另一個|第個
另一邊|第便
另一面|第便
另加一些佐料|加底
另外|另加
另外的人|第二個
叨登|反轉
只值一粲|得啖笑
只剩下|剩得
只剩下部份尺碼|斷碼
只在|爭在
只好|惟有
只是|淨係
只是陳列而不售賣|齋擺唔賣
只會吃飯而不願做事的人|蛀米大蟲
只會說不會做|識彈唔識唱
只當某人沒來|當冇嚟
只當沒來才|當冇嚟
只管|即管
只能博人一笑而已|得啖笑
只能得到|賺得個
只落得一場空|得個吉
只落得|賺得個
只靠素食度日|挨齋
叫倒好兒|噓
叫出租|截的士
叫喊|嗌
叫喚|嗌
叫窮|呻窮
叫花子|乞兒
叫車|截的士
叫魂|喊驚
召妓|叫雞
召集羽翼|班馬
召集黨徒|班馬
叮咬|針
叮噹五四|三扒兩撥
可一而不可再|一次起、兩次止
可不可以|得唔得
可不是|唔係
可了不得啦|該煨
可以上升的氣球|升氣球
可以使用|用到
可以商量|有得傾
可以嗎？|得啩？
可以|得
可以成交|有交易
可以斷定|睇白
可以用|用到
可以看|睇得過
可以考慮|有得諗
可以見|見得
可以說|可以話
可以走了|行得
可以選擇|有得選
可以選|有得選
可口|和味
可可|唂咕
可可粉|谷古
可心|合心水
可怒|可嬲也
可怕|得人驚
可想而知|可想然之
可愛|得意
可憐|冇陰功
可是|之但係
可疑|蹺蹊
可算|都算
可羞|羞家
可能|似
可能性很大|九成九
可能有變化|有古怪
可與之打交道|有交易
可靠的資料|堅料
可靠|穩陣
台|架
台球桌子|桌球檯
台階兒|步級
台階|石級
叱責|砌
史瓦濟蘭|斯威士蘭
右側|右便
右手的這邊|右手便
右撇子|右肴
右方|右手邊
右耳刀兒|耳仔邊
右轉|轉右
右邊兒|右手便
右邊|右便
司令官|兵頭
司機|柴可夫
吃一看二眼觀三|坐一望二
吃上頓沒下頓|有朝冇晚
吃下去|食落
吃不消|頂唔順
吃中飯|食晏
吃也沒有一口好吃|冇啖好食
吃了中飯|食咗晏晝
吃了午飯|食咗晏晝
吃個夠|擦餐飽
吃個痛快|吃一次勁的
吃價兒|食價
吃光|食晒
吃冤枉虧|食死貓
吃到飽|任食
吃剩下|食剩
吃剩|食剩
吃力|抵力
吃午飯|食晏
吃啞巴虧|暗啞抵
吃喝嫖賭|嫖賭飲吹
吃喝往來|靠飲靠食
吃喝|飲食
吃嗆了|吞錯喉
吃夜宵|宵夜
吃好住好|好食好住
吃定|食硬
吃小虧佔大便宜|除笨有精
吃年夜飯|團年
吃得不多|細食
吃得乾乾淨淨|汁都撈埋
吃得多|大食
吃得太飽|飽死
吃得少|細食
吃得舒服自在點兒|辛苦搵嚟自在食
吃得貴而不實在|到喉唔到肺
吃撐|食飽飽
吃早飯|食晏晝飯
吃晌飯|食晏晝飯
吃晚飯|食晚飯
吃東西|食嘢
吃槍子|食蓮子羹
吃水|食水
吃油|欶油
吃火鍋兒|打邊爐
吃火鍋|打甂爐
吃獨食|獨食
吃現成兒|起尾注
吃現成|起尾注
吃白食|靠黐
吃秤|呃秤
吃素的女人|齋婆
吃素|食齋
吃老本兒|捱穀種
吃老本|食穀種
吃膩了|食滯
吃茶|嘆茶
吃葯|食葯
吃葷|食雜
吃藥|服
吃虧|蝕底
吃裡扒外|食碗面反碗底
吃西餐用的刀子|餐刀
吃豆腐|索油
吃起來很香|香口
吃起來|食起嚟
吃軟不吃硬|受軟唔受硬
吃進去|入口
吃過|食過
吃醋|呷醋
吃閉門羹|摸門釘
吃頭|食頭
吃飯不要錢|食阿爺飯
吃飯用的小盆|飯兜
吃飯|食飯
吃飽喝足|飲飽食醉
吃飽喝醉|飲飽食醉
吃飽|窒飽
吃香|當時得令
吃驚|打突兀
吃黑棗兒|食蓮子羹
各人的口味不同|各花入各眼
各位|諸生
各分一半|兩份
各半攙和|對摳
各地|周圍
各家|家家
各式各樣|淋淋瀋瀋
各種|各樣
各種食具的總稱|碗碗碟碟
各自|各有各
各走各|各行各路
各走各的路|各行各路
各走各路|各行各路
各顯神通|各施各法
吆喝|喝
合不來|行唔埋
合伙兒|佮份
合伙|孖份
合作不成|攪唔埋欄
合作|啱手
合作得好|攪得埋欄
合作者|拍檔
合併|併埋
合八字|佮八字
合力|夾手夾腳
合口|埋口
合|啱
合在一處|埋堆
合在一起|共埋
合夥|佮份
合得來|行得埋
合心意|合心水
合心意的貨品|心水貨
合拍|埋欄
合格證|出世紙
合算|着數
合群|埋堆
合股|佮份
合襯|夾
合計|佮
合該倒霉|好衰唔衰
合謀|佮計
合資|夾份
合起來|佮埋
合身|帖服
合適|合襯
合頁|門鉸
吉他|結他
吉利|好意頭
吉利話兒|時文
吉布地|吉布提
吉里巴斯|基里巴斯
吊傘式蚊帳|羅傘帳
吊兒郎當|冇紋路
吊|椗
吊槽|吊渠
吊環|雙環
吊着賣|吊高嚟賣
吊胃口|吊癮
吊腳|吊骨
吊銷牌照|釘牌
吊鋼線|吊威也
吊鐘花|吊鐘
吊頸|掛臘鴨
同一|同埋
同一類人|一族
同事|拍檔
同住一起|住埋
同住|同屋
同姓的人|老宗
同學|書友
同宗|老宗
同心協力|佮手佮腳
同性戀|搞基
同意|應
同房|行埋
同歸於盡|一鑊熟
同牀|孖鋪
同窗|書友
同花順|同花兼夾順
同行|行家
同輩|同儕
同鄉|鄉里
同門派的人|同門
同類相鬥|狗咬狗骨
名伶|老倌
名利雙收|名成利就
名字|全名
名望|名堂
名氣|名銜
名氣很響|響噹噹
名片|咭片
名稱|字號
名聲好|馨香
名聲很壞|周身屎
名聲|招牌
名藝人|大佬倌
名藝人的私人助理|褓姆
名額|額
吐司|多士
吐瓦魯|圖瓦盧
吐痰|吐口水痰
吐白沫|嘔白泡
吐苦水|呻笨
吐血|嘔電
向上|上
向上翹|趷
向人要|愛
向他學|睇住佢頭
向來|不留
向後彎腰|拗腰
向後退|褪
向日葵花|葵花
向正前方去|照住鼻哥去
向着|爭
向著|向住
向顧客硬要錢|開刀
吝嗇|孤寒
吝嗇的人|孤寒種
吝嗇的男人|鐸叔
吝嗇鬼|孤寒仔
吞不下那口氣|條氣唔順
吞入肚中|落膈
吞錯喉|噈喉
否則|唔係
否認前言|反口
否認|唔認
吧？|啫？
吧！|囉！
吩咐|話落
含咂|嗒
含着眼淚|眼濕濕
含羞草|怕醜草
吭氣兒|答搔
吭聲兒|答搔
吭聲|出聲
吮|嘬
吱吱喳喳地大聲說話|吱喳
吱吱喳喳|巴喳
吱吱浸浸|整整浸浸
吱聲|開聲
吵吵嚷嚷|嘈喧巴閉
吵吵鬧鬧|嘈嘈閉閉
吵吵鬧鬧的人|哇鬼
吵|嘈
吵嘴|鬧交
吵嚷|嘈吵
吵得厲害|嘈生晒
吵得慌|吵耳
吵成一片|嘈生晒
吵架|嘈交
吵死人|嘈生晒
吵耳|嘈吵
吵耳朵|嘈耳
吵鬧一下|嘈兩嘈
吵鬧不停|嘈嘈閉
吵鬧|鬧交
吸乾|撦光
吸|嗍
吸墨紙|印水紙
吸引|引
吸引目光|有睇頭
吸引處|賣點
吸引重點|賣點
吸晴|搶眼
吸毒|啪丸
吸毒者|道友
吸水過多貌|淰瀼
吸汗|欶汗
吸油|欶油
吸滿|淰
吸煙|食煙
吸管兒|飲筒
吸管|飲筒
吸透|淰
吸進|啜入
吸鐵石|攝石
吸食毒品|追龍
吸飲|嗍
吸鴉片煙者|道友
吹了|掟煲
吹哨者|吹雞人
吹喇叭|啲咑
吹捧|笠高帽
吹|放葫蘆
吹枕邊風|告枕頭狀
吹牛不交稅|吹水唔抹嘴
吹牛吹得天花亂墜|車天車地
吹牛大王|大炮友
吹牛屄|放葫蘆
吹牛皮|車大炮
吹牛|車大奅
吹風兒|放聲氣
吹風機|風筒
吹鬍子瞪眼|吹鬚睩眼
吻了我一下|惜咗我一啖
吻|啜
吼叫|嗌
呀！|㗎！
呆傻貌|傻傻戇戇
呆呆|一轆木噉
呆呆的樣子|呆呆鐸鐸
呆子|木嘴
呆|戇
呆板內向|古縮
呆板|死咕咕
呆滯|木獨
呆瓜|壽頭
呆笨|呆鈍
呆頭呆腦|壽頭壽腦
告|吿
告密|㧻魁
告枕邊狀|告枕頭狀
告發|㧻魁
告示牌|水牌
告訴他|講畀佢聽
告訴你|講畀你聽
告訴別人|講畀人哋聽
告訴我|講畀我聽
告訴|話畀
告誡|千祈
告饒兒|叫唔敢
呢？|㗎？
周圍|四便
周轉|走趲
呱嗒板兒|測板
味不夠濃|淡茂茂
味兒衝|掯
味厚|濃
味淡|冇聞冇味
味精|味粉
味道不濃|淡瀎瀎
味道|味
味道好|好味
味道很淡|淡滅滅
味道很鮮|鮮味
味道美|和味
味道鮮美|鮮甜
味鮮|鮮味
呼來喝去|呼呼喝喝
呼叫|召喚
呼叫器|傳呼機
呼吸|唞氣
呼吸困難|氣頂
呼呼|扉扉聲
呼哧呼哧|靴靴聲
呼喚|嗌
呼嚕聲|咕咕聲
呼天搶地|喊苦喊忽
呼拉圈|呼拉圈
呼風喚雨|要風得風、要雨得雨
命不好|命醜
命令|嗌
命令殼|命令解譯器
命"|命水
命大|大命
命好|命正
命運不好|命醜
命運|命水
命運好|有衣食
咀嚼|噍
咀嚼聲|雜雜聲
咂|嗒
咂嘴聲|嗒嗒聲
咂糖果的聲音|嗒嗒聲
咋呼|巴喳
咋咋呼呼|沙沙滾
和|同
和善和軟弱|腍
和善|腍善
和女人鬼混|搞女人
和好|好返
和尚要錢經也賣|事急馬行田
和我一齊|偕我
和牌了|食胡
和牌|食糊
和睦|和揖
和藹|和揖
咕咕叫|咕咕聲
咕嚕|嗢
咖啡色|啡色
咖喱粉|咖喱
咖喱醬|咖喱
咦|哈
咧着大嘴笑|笑口噬噬
咧著嘴笑|笑口噬噬
咧開|撝
咬不動|咬唔入
咬住|噏實
咬|啃
咬牙|齧牙
咬碎|噍爛
咬耳朵|咬耳仔
咭|咭片
咱|我哋
咳嗽的聲音|鉗鉗聲
咽不下那口氣|唔抵得頸
哀求|㥋
品嚐|嗒
品性淳和|淳品
品格不好|衰
品格|格
品格端正|貴相
品行不好|臭品
品行不端|蔫崩爛臭
品行|操
品質上乘|靚
品質劣|水皮
品質差|水皮
品質|質素
哄女孩子|冧女仔
哄嬰兒|藹
哄小兒睡覺|欸
哄騙|棍騙
哆哆嗦嗦|忳忳震
哆嗦|打震
哆裏哆嗦|騰騰震
哇！|嘩！
哈哈大笑|笑到噱噱聲
哈巴狗|跟尾狗
員工|伙計
哥們|老友記
哥哥|大佬
哥斯大黎加|哥斯達黎加
哨兒|雞
哨子|銀雞
哩|咪
哪一個|邊個
哪一|幾多
哪一邊|邊便
哪位|邊個
哪個|邊一個
哪兒只|點只
哪兒合兒|邊處
哪兒有這好事|有咁好死咩
哪兒|邊度
哪合兒|邊處
哪會兒|幾時
哪種|邊樣
哪裏知道|點知
哪裏|邊度
哪裡哪裡|乜說話吖
哪|邊
哪邊兒|邊便
哭|喊
哭笑不得|不知好笑還是好怒
哭聲|嗷嗷聲
哭鼻子|流馬尿
哮喘|撦瘕
哮喘病|牽瘕
哮喘鳴音|曉曉聲
哺乳動物|驢
哼哼|呀呀聲
哽心哽肺|哽心
唆使|唆擺
唇槍舌劍|牙斬斬
唇膏|口唇膏
唇裂|崩口
唇青臉白|面青口唇白
唔係|嘛
唧唧喳喳|吱吱喳喳
唬嚇|拋
售票處|票房
售貨攤|攤檔
售賣冰淇淋汽車|雪糕車
唯恐|慌死
唯有|唯有
唰唰|坎坎聲
唱|上手
唱個夠|大唱特唱
唱功|喉底
唱反調|打對台
唱對臺戲|打對臺
唱戲|大佬倌
唱片|唱碟
唱雙簧|撦貓尾
唱高調|講得口響
唸了|哦咗
唸|讀
唾沫星子|口水溦
啃|咪
啃書本|刨書
啃書本的人|冞家
商人|生意佬
商品的外觀|賣相
商品裝潢裝紙|招紙
商埠|埠
商店倒閉|埋口
商店晚間閉門|上鋪
商店牌號|堂
商店|舖頭
商業活動興旺的地區|旺區
商標|牌
商標紙|招紙
商討計謀|度橋
商談|斟
商議|講
商量|講
啊！|嗄！
問倒了|問起
問清楚|問真
問話|落口供
問題不絕|問題多多
問題全解決了|一天都光晒
問題|阻滯
啜|渳
啞人|阿啞
啞口無言|擘大個口得個窿
啞嗓子|豆沙喉
啞巴|啞仔
啟動|起機
啟動開關|撳掣
啤酒|老番涼茶
啥|乜
啥？|乜？
啥事兒|乜東東
啥玩意兒|乜東東
啼笑皆非|不知好笑還是好怒
喀拉蚩|卡拉奇
喂貓的魚|貓魚
喃喃|吟
喃喃自語|吟沉
善始善終|好手尾
善後|執手尾
善於思考|有諗頭
善於打個人小算盤|縮骨
善有善報|好心有好報
善良淳厚|淳善
善良而軟弱|淰善
善良|馴品
善解人意|話頭醒尾
善變|午時花六時變
善辯|好辯駁
喇叭聲音|響按聲
喉嚨沙啞|喉沙
喉嚨變得沙啞|破金
喉嚨|頸喉
喉急|淋擒
喉結|喉核
喊倒好兒|儕臺
喊叫|嗌
喊哩喀喳|時哩沙啦
喊破|譅破
喊窮|呻窮
喊話|搨心口
喋喋不休|牙譫譫
喔！|喎！
喘不過氣來|氣咳
喘不過氣|有氣冇碇唞
喘大氣|唞大氣
喘息|撦氣
喘氣|唞氣
喜劇|笑片
喜大吃大喝|好飲好食
喜好|嗜好
喜形於色|得色
喜愛|歡喜
喜棚|酒廠
喜歡出風頭|要威要面
喜歡說話|好傾好講
喜歡|鍾意
喜|興
喜酒|喜酌
喝一杯酒|飲杯
喝倒彩|儕臺
喝倒采|柴台
喝剩湯|飲水尾
喝口水|飲啖水
喝呼草|怕醜草
喝喜酒|飲新婦酒
喝寡酒|飲清酒
喝斥|喝
喝水以充飢|飲水飽
喝滿月酒|飲薑酒
喝茶吃點心|嘆茶
喝茶|歎茶
喝西北風|食北風
喝酒|劈酒
喝醉的男人|醉酒佬
喝醉|飲大着
喝開水|飲茶
喝|飲
喧嘩|嘈喧巴閉
喧賓奪主|妹仔大過主人婆
喪失自尊|低威
喪葬費|燒埋
喬治亞|格魯吉亞
單一|淨
單人床|獨睡
單人旁|企人旁
單件西裝|單吊西
單個兒|單丁
單個|單丁
單元|單位
單幅|單封
單幫商人|走水客
單打獨鬥|隻揪隻
單排扣兒|單襟
單排紐扣|單襟
單撥兒|單丁
單是|單係
單杠|杠架
單槓|槓架
單|淨
單獨|單丁
單獨打鬥|隻揪
單眼相機|單鏡反光機
單磚兒墻|單牏墻
單立人兒|單企人
單立人|單企人
單色|齋色
單薄|單料
單調乏味|獨沽一味
單調|乾噌噌
單身漢|寡佬
單間板墻|板障
喲！|噃！
嗅覺靈敏|好鼻
嗆嗓子|戳喉
嗆鼻子|攻鼻
嗆鼻|攻鼻
嗎？|啊？
嗓子啞|口啞
嗓子|喉
嗓子沙啞|煙屎喉
嗓門兒|聲喉
嗓門兒高|通喉
嗓門|聲喉
嗓音似鵝叫|鵝公喉
嗓音發啞|聲喉澀
嗓音|聲喉
嗜好深|爛癮
嗜好|細藝
嗜賭|爛賭
嗜賭的人|爛賭二
嗝兒|司肊
嗡嗡作響|耾耾聲
嗨|哈
嗩吶的俗稱|吹打
嗷嗷地哭|喊到一句句
嘀咕|吟噆
嘀嘀咕咕|心大心細
嘆|呻
嘆氣|唞大氣
嘈雜|嘈喧巴閉
嘍！|噉！
嘍囉|馬仔
？|嘎？
嘎巴豆|豆釘
嘔吐|嘔
嘗一下味道|試味
嘗味|嗒
嘗過|試過
嘛|啊
嘜|咪
嘜筒|咪高風
嘟嚕|搊
嘩啦|傾框
嘩啦嘩啦|化化聲
嘩嘩|沙沙聲
嘬|啜
嘮叨不止|諃氣
嘮叨個沒完|譖氣
嘮叨|口多多
嘰嘰咕咕|吱吱斟斟
嘰里咕嚕|飛哩啡呢
嘲笑|儕
嘲諷|村盡
嘴乖|口乖
嘴唇兒|口唇
嘴唇|口唇
嘴唇發白|面青口唇白
嘴嚴|口密
嘴巧|口乖
嘴巴不嚴|口疏
嘴巴厲害|牙尖嘴利
嘴巴嚴|密實
嘴巴子不肯吃虧|牙尖嘴利
嘴巴癢癢|口痕
嘴巴硬|牙詀詀
嘴巴耍強|牙斬斬
嘴巴要強|牙斬斬
嘴快|快口
嘴快者|啄
嘴把式|口水佬
嘴拙|口拙
嘴沒遮攔|把口唔收
嘴甜|口甜舌滑
嘴癢|口痕
嘴癢癢|口痕
嘴硬|口硬
嘴笨|口拙
嘴緊|密實
嘴裏不乾不淨地罵人|媽媽聲
嘴角|口椏角
嘴饞|口漮漮
嘴饞的人|為食貓
嘶啞|坼
嘻|欯
嘿|哈
噁心|鶻突
噌噌|喳喳聲
噎到|鯁親
噎死|骾死
噱頭|綽頭
噴嚏|乞嗤
噴壺|花灑
噴射|瀄
噴射聲|啡啡聲
噴水壼|花灑
噴|瀄
噴頭|花灑
嚇了一跳|嚇到躓一躓
嚇人|得人驚
嚇個夠|嚇餐飽
嚇倒|嚇窒
嚇唬|拋浪頭
嚇唬膽小的人|嚇鬼
嚇壞了|嚇親
嚇壞|嚇窒
嚇得發抖|震忳忳
嚇怕了|嚇怕
嚇着|嚇親
嚥氣了|瓜直
嚴厲地看|掘
嚴密|密籠
嚴密防範|百密一疏
嚴實|密實
嚴絲合縫|相食
嚴重精神失常|黐孖筋
嚼勁|咬口
嚼舌頭|口花花
囂張|竄
囉唆|長氣
囉嗦個沒完|長氣
囉嗦|吟譛
囉囉唆唆|稟神
囑咐|交待
囚徒|監躉
囚犯|監躉
四下裏|四便
四分之三|三個骨
四分五裂|四分五散
四十五分鐘|九個字
四十分鐘|八個字
四十|卌
四周|四周圍
四周圍|四便
四四方方|四四正正
四方框子|四方框
四方臉|國字口面
四眼兒|四眼佬
四眼田雞|四眼佬
四肢發達|大隻雷雷
四處串門|過街過巷
四處|四圍
四處想辦法找票|撲飛
四處遊蕩|流離朗蕩
四號電池|筆芯電
四輪冰鞋|雪屐
四面|四便
四點整|沓正四點
回來上班|返工
回來|返嚟
回到|走回
回味無窮|食過返尋味
回味|返尋味
回回|回教佬
回報|匯報
回天無力|神仙難救
回家|返屋企
回尾|回本
回形刀|萬字夾
回形針|萬字夾
回想|諗翻
回憶|諗翻
回憶起|觸
回應|理下
回手|戾手
回扣|回佣
回收廢品者|收買佬
回收筒|回收桶
回旋|走趲
回暖|回南
回民|回教佬
回看|看返
回答不出|口啞
回答|答
回覆|覆返
回路綫|水綫
回|返
回過頭來|戾轉頭
回電話|覆機
回頭|轉頭
回顧|睇返
囟門|腦囟
因下雨而潮濕|落雨絲濕
因不滿意而任性|賭氣
因事情難辦而生氣|霎氣
因利乘便|打蛇隨棍上
因噎廢食|斬腳趾避沙蟲
因悶熱而中暑|焗親
因搖晃而溢出|蕩
因此|就係噉
因為|皆因
因而|至得
囫圇吞下去|掂喉吞
困難|難
固執|硬頸
固定不動|定
固定不變|梗
固定|梗
固定的房間|梗房
固然|固然之
圈住|框
圈兒|框
圈|圂
圈套|中招
圈子|框
圈養的鴨子|泥鴨
國家|阿爺
國際足球總會|國際足球協會
圍住脖子的豎領|樽領
圍嘴兒|口水肩
圍巾|頸巾
圍帎|腰帎
圍攏|哄
圍|攬
圍爐|打邊爐
圍着|朏
圍繞|圍
圍肩兒|口水肩
圍脖兒|頸巾
園丁|花王
園林中的假山|假石山
園林工|花王
圓圓|圓碌碌
圓夢|解夢
圓形指紋|腡
圓|文
圓柱形枕頭|腰枕
圓柱形物|碌
圓條狀粗粉條|瀨粉
圓溜溜|圓碌碌
圓滑可通融|圓融
圓滑靈活|妙品
圓滾滾|圓睩睩
圓珠筆|原子筆
圓白菜|椰菜
圓眼|龍眼
圓菜椒|燈籠椒
圓頂蚊帳|傘帳
圖一時方便|貪一時方便
圖像|圖片
圖好玩|貪得意
圖方便|貪方便
圖書館|拉記
圖有趣|貪得意
圖紙|圖則
圖釘|撳釘
圖開心|貪得意
團團|𧽼𧽼圈
團團轉|𧽼𧽼轉
團成餅的乾麵條|麵餅
團狀乾麵條|麵餅
團盡年|團年
團粉|豆粉
團隊|隊伍
團體跳繩|跳大繩
團魚|水魚
土包子|老土
土匪打家劫舍|做世界
土匪搶倉庫|爆倉
土匪|賊佬
土匪頭|草頭王
土地爺|土地
土坑|坎
土坯|泥磚
土字旁|土字邊
土氣的人|大鄉里
土氣|老土
土特產|手信
土簸箕|垃圾鏟
土著|地膽
土裏土氣|大鄉里
土豆兒|薯仔
土豆|薯仔
土路|泥路
土霸|陀地
土頭土腦|老鄉
土黃色|屎黃
在一齊|喺埋一齊
在世|在生
在中|向
在乎|志在
在人前丟臉|失禮人
在半空晃蕩|吊吊揈
在|喺
在地上打滾兒|捵地
在地上打滾|碌地
在學學生|學生哥
在學的學生|學生哥
在客廳睡覺|做廳長
在家|傍家
在床上打滾兒|捵床捵席
在意|掛意
在愛情上不專一|花心
在手冊上簽名|簽手冊
在政府部門工作|打皇家工
在旅館開房間|開房
在晚上外出|出夜街
在最後面|孻尾
在正中|正中間
在此|喺度
在空腔盡處不通|盟籠
在紙上湮開|淰
在背後說壞話|擉背脊
在船上工作|行船
在行|熟行
在街頭擺攤兒|擺街
在近處|就近
在這裏|嚮度
在這裡|喺度
在這邊|喺度
在那裡|喺度
在那邊|喺度
圬墻|批盪
地上|地下
地下妓院|架步
地下室|地庫
地下賭場|大檔
地位低|細粒
地位|埞企
地底下|地底
地攤兒|地檔
地攤子|擺街邊
地攤貨|地貨
地方|埞
地方寬闊空曠|開揚
地方小|淺窄
地方很小|白鴿籠
地方惡霸|地頭蟲
地方窄小|腌臢
地板|地下
地板磚|階磚
地栗|馬蹄
地段|地頭
地毯|地氈
地滾球|轆地波
地痞|竄仔
地盤兒|地盤
地盤|地頭
地線|水綫
地蛋|薯仔
地震|震
地面凹凸不平|一岩一窟
地面|地下
地頭蛇|地膽
地頭蟲|地膽
均勻|勻洵
坐一坐|坐下先
坐下|坐低
坐冷板凳|炖冬菇
坐吃山空|坐食山崩
坐地鐵|搭地鐵
坐墊|椅墊
坐大牢|坐花廳
坐好|入席
坐得很安穩|坐定定
坐得正|腰骨戙戙
坐月子|坐月
坐班房|坐花廳
坐船偷渡|屈蛇
坐船游覽|游河
坐落方向|坐向
坐車不買票|坐霸王車
坐車|搭車
坑人|靠害
坑坑洼洼|一岩一窟
坑害|靠害
坑蒙拐騙|呃呃騙騙
坦尚尼亞|坦桑尼亞
坦率|直白
坦白|攤心
坦米爾|泰米爾
坦誠相見|開心見誠
垂下|耷低
垂下腦袋|耷頭
垂了下來|髧晒落嚟
垂到地上|拖地
垂尾犬|耷尾狗
垂涎|猴
垂頭喪氣|耷頭耷腦
垂頭喪氣貌|頭耷耷
垂|髧
垃圾堆置場|垃圾崗
垃圾|擸𢶍
垃圾箱|垃圾筒
垮臺|冧檔
埋|壅
埋怨|怨唱
埋葬|埋
埋街|食井水
埋頭|埋頭埋腦
埋頭幹某事|鋤
埋首|錑個身
埠|接口
執仔婆|執媽
執拗|拗頸
執照|牌
執行|行
執行起來|執一執
執骨|執金
培育|供書教學
培養|菢
基於|跟埋
基模|配方
基礎|底
基礎建設|基建
堂姐|堂家姐
堂房|疏堂
堂會組織|堂口
堂|疏堂
堅固|穩陣
堅固耐用|實淨
堅守立場|企硬
堅決完成|殺起
堅決|強力
堆堆|一舊舊
堆拼|砌
堆棧|埠
堆砌|砌
堆積|積
堤堰|基圍
堤壩|基圍
堪輿家|風水佬
報名參加了|報了
報告|報
報復|找晦氣
報應|折墮
報攤兒|報紙檔
報紙攤|報紙檔
報販子|報紙佬
報賬|出公數
報道|賣
報銷|出公數
場所|地頭
場面大|大陣仗
場面混亂|倒瀉籮蟹
堵住嘴|椊嘴
堵住對方嘴|懫
堵住|食
堵塞|擠塞
堵塞通道|阻滯
堵心|頂心頂肺
堵路|阻街
堵車|塞車
塊兒大|大件
塊錢|文
塊頭|個頭
塌|坐
塌房|凜屋
塌棵菜|矮腳白菜
塑料刀子|膠刀
塑料刀|膠刀
塑料叉子|膠叉
塑料喉管|膠喉
塑料|塑膠
塑料套|膠套
塑料娃娃|膠公仔
塑料拖鞋|膠拖
塑料杯|膠杯
塑料桶|膠桶
塑料瓶|膠樽
塑料盒子|膠盒
塑料盒|膠盒
塑料眼鏡|膠眼鏡
塑料碟子|膠碟
塑料碟|膠碟
塑料花|膠花
塑料袋兒|膠套
塑料製品|膠
塑膠叉|膠叉
塑膠|塑料
塑膠桶|膠桶
塑膠水管|膠喉
塑膠瓶|膠樽
塑膠盒子|膠盒
塑膠眼鏡|膠眼鏡
塑膠罐|膠樽
塑膠袋|膠袋
塔吉克|塔吉克斯坦
塗了|畫花
塗刷|掃
塗得|油
塗抹|刮
塗污|畫花
塗|盪
塗脂抹粉|搽脂蕩粉
塗藥|擦藥
塗鴉|畫公仔
塘堤|塘膊
塘尾仔|塘尾艇
塘的邊岸|塘膊
塞|𤗈
塞子|窒
塞席爾|塞舌爾
塞拉耶佛|薩拉熱窩
塞擠|擠塞
塞牙縫|黐牙罅
塞進|𤗈入
塞進灶底下|攝灶罅
塞飽|窒飽
填房|後底婆
填肚子|醫肚
填飽肚子|懫飽個肚
塵土|泥塵
墊兒|薦
墊墊肚子|頂肚
墊子|墊
墊底兒|打底
墊底|打底
墊高|𤗈高
墜進陷阱|墮下陷阱
增加|提返
增加鮮味|吊味
增添|加添
墨嘴|墨頭
墨水筆|水筆
墨鏡|黑瞧
墮入陷阱|墮下陷阱
墮落|折墮
墳墓|山墳
墳|山墳
壁櫥|壁櫃
壁紙|牆紙
壁虎|簷蛇
壓倒|打沉
壓力鍋|高壓煲
壓場|鎮場
壓平|壓扁
壓彎了腰|斷擔挑
壓歲|笮年
壓歲錢|矺年
壓死|砸死
壓秤|重秤
壓|笮
壓迫|逼
壞了|玩完
壞事了|涴
壞事|衰嘢
壞傢伙|衰公
壞兆頭|唔好意頭
壞到家了|衰到貼地
壞女人|衰婆
壞女孩|衰女
壞孩子|衰仔
壞家伙|衰神
壞年成|唔好時年
壞年景|唔好時年
壞掉了|涴咗
壞朋友|損友
壞樣兒|衰樣
壞處|弊處
壞蛋|躝癱
壞|衰
壞透了|衰到極
壞點子|屎坑計
壯工|咕哩
壯漢|大隻佬
壽命不長|短命
壽星|壽星公
夏天|熱天
夏日|天時熱
外來|嚟
外公|公公
外出了|出了街
外出|出街
外國人|西人
外國佬|鬼佬
外國|外埠
外國女人|鬼婆
外國女孩|鬼妹
外國姑娘|鬼妹
外國少女|鬼妹
外國男人|鬼佬
外國的商埠|埠頭
外國話|鬼佬話
外國長大的女孩|竹升妹
外國電影|西片
外地的電視劇|外劇
外套|褸
外婆|婆婆
外帶|拎走
外幣|西紙
外快|下欄
外江人|撈鬆
外片兒|卡片
外甥|姨甥
外皮光滑|皮光肉滑
外號|花名
外行|唔在行
外衣|面衫
外表光滑|光身
外表好看|好眉好貌
外表無附著物|光身
外表突出|有型有款
外表|賣相
外賬|街數
外遊|出埠
外邊兒|外便
外邊|出面
外面|出便
外面的人|街外人
外頭|外便
夙怨|牙齒印
多一事不如少一事|少件得件
多一些|多少少
多一個香爐多一位神道|多隻香爐多隻鬼
多久|幾耐
多些|鬆啲
多付|長
多元|零蚊
多半|九成九
多嘴|多口
多嘴多舌|口多多
多嘴的人|口痕友
多塊錢|零蚊
多塊|零蚊
多多少少|唔多唔少
多好|幾好
多寬|幾闊
多少|幾多
多少？|幾多啊？
多少時間|幾耐
多年|成年以上
多得很|多那那
多手多腳|手多多
多手|手多
多承惠顧|承惠
多明尼加|多米尼加
多會兒|幾時
多棱角|三尖八角
多此一舉|多餘喇
多死了|多到死
多用插座|三叉蘇
多的是|大把
多看|看多
多種多樣|雜
多等|等多
多管閑事|多多事幹
多管閒事|多多事幹
多給|長
多肉|好肉
多虧|多得
多試|試多
多話|多口
多話的人|阿支阿左
多謝了|多謝晒
多謝關心|有心
多費口舌|嗲
多退少補|多除少補
多遠|幾遠
多采多姿|多姿多彩
多長時間|幾耐
多面手|萬能老倌
多餘|凸
多麼多|幾多
多麼|幾恁
多點|多啲
夜咪麻|黑麻麻
夜壼|尿壼
夜|晚
夜晚|晚
夜校|夜學
夜消兒|宵夜
夜深了|夜麻麻
夜深|夜麻麻
夜游的人|夜游鶴
夜班|夜工
夜生活|夜浮
夜盲症|雞盲
夜裏很晚|夜麻麻
夜裡|晚頭黑
夜貓子|夜鬼
夠交情|老友
夠你忙|禁你做
夠個兒|夠嚟
夠勁兒|夠喉
夠味兒|夠喉
夠哥們|老友
夠嗆|好傷
夠戧|交關
夠手段|手硬
夠排場|架勢
夠本兒|值回票價
夠本|夠皮
夠氣派|係威係勢
夠用|夠使
夠膽量|好膽
夠鹹|夠味
夢話|開口夢
夢魘|被鬼矺
夥伴|拍檔
大一點兒|大少少
大一點|大少少
大不了|至多
大事|大件事
大人|大人大姐
大人物|猛人
大伯|伯
大伯子|大伯
大伯爺|大伯
大便|屙扽
大個兒|大隻
大個子|大隻佬
大兒子|頭長仔
大刀|關刀
大前兒|大前日
大前天|大前日
大副|大車
大力吹噓|力谷
大包小包|一搊二掕
大叔|阿叔
大口吃|啃
大口喝水聲|括括聲
大叫大嚷|鬼殺咁嘈
大吃一頓|噍餐勁
大吃|刷
大吃大喝|暴飲暴食
大吉大利|利利市市
大員|大腳色
大哥|大佬
大喊大叫|聲大夾嘈
大嗓門|大聲公
大嚷大鬧|聲大夾嘈
大型主機|大型機
大型冰柜|雪柜
大型甲魚|山瑞
大型芋頭|荔浦芋
大場面|大陣仗
大塊兒|大件
大塊|底
大塊頭|大䊆
大大咧咧|大情大性
大大|大大個
大大的眼睛|眼大大
大|大隻
大天白日|日光日白
大夫|醫生
大女兒|大女
大奸人|大奸角
大姊|大家姐
大姐|大姊
大姑姑|大姑姊
大姑子|大姑
大姑母|大姑姊
大姨兒|大姨媽
大姨子|大姨
大婆兒|大婆
大嫂|阿嫂
大嬸|二叔婆
大嬸兒|阿嬸
大孩子|大唔透
大宗|大單
大官|大粒色
大客戶|大客
大家合伙|儕嘩嘩
大家|大朋
大家姐|大家
大家起哄|儕
大寫|大草
大專|專上
大小合適|抱
大小|大細
大小子|男仔頭
大小孩兒|大唔透
大少奶奶|大少奶
大少爺|太子爺
大師傅|伙頭
大幅減價|割價
大平賣|大出血
大年|大造
大庭廣眾|百眾
大廳|大堂
大律師|大狀
大後兒|大後日
大後天|大後日
大情大性|癲癲廢廢
大意|失魂
大感安慰|飲得杯落
大手|手爽
大拇哥|手指公
大拇趾|腳趾公
大拿大主|自把自為
大排場|大陣仗
大搖大擺|大模斯樣
大料|八角
大方地拿去送人|派街坊
大方|大臺
大方得體|體面
大於|大過
大早晨|早晨流流
大晴天兒|好天
大木櫃|大櫃
大木頭|大轆木
大案|大茶飯
大模大樣|大模斯樣
大款|水喉
大母指|手指公
大比數勝出|贏足成條街
大氣|大臺
大汗淋漓|身水身汗
大油|豬膏
大海螺|響螺
大清早兒|朝早
大清早|大早
大減價|大出血
大煙鬼|道友
大理石|雲石
大甩賣|跳樓
大男人|男人佬耇
大發雷霆|發啷厲
大白天|日頭蕩蕩
大白菜|紹菜
大的力氣|牛力
大的排水明溝|水坑
大的本地白菜|大白菜
大的欺負小|大石責死蟹
大的洋娃娃|大公仔
大的白瓜子|瓜仁
大眼睛的人|紅眼鱒
大眼睛|眼大大
大眼鯛|大眼雞
大票兒|大紙
大箱子|籠
大篇幅|大幅
大粒兒|大粒
大粒的生鹽|粗鹽
大粒鑽石|巨鑽
大約|約莫
大缸|甕缸
大群|軍
大老婆|大婆
大老粗兒|老牛精
大耍嘴皮子|口水多過茶
大聲叫喊|呱呱叫
大聲地呵斥人|喝神喝鬼
大聲胡說|聲大夾冇準
大聲說話|口水花噴噴
大肆宣傳|大煲特煲
大肚子病|臌脹
大肚子|肥肚腩
大肚|巨腩
大肚皮|大肚腩
大脖子|大頸泡
大腿|大髀
大腿根部|髀罅
大膽兒|好膽
大膽|膽粗
大舅媽|大妗
大舅子|大舅
大舌頭|黐脷根
大花臉|大花面
大茴香|八角
大螺角|號角
大蟒蛇|蚺蛇
大街上|大街大巷
大街上的景象|街景
大街小巷|橫街窄巷
大衣|大褸
大衣式連衣裙|褸裙
大衣櫃|高柜
大衣櫥|企身柜
大規模|大單
大豆|白豆
大豆芽|大豆芽菜
大象|大笨象
大象鼻子|象拔
大跌|插水
大路貨|行貨
大送人情|賣大包
大過年|新年流流
大部分|多數
大量地拿|擸
大量|大把
大鍋飯|大鑊飯
大鐵鍋|鑊頭
大長鏡子|照身鏡
大門出口|大門口
大門外的一道小門扇|矮門
大門牙|大板牙
大門|龍門
大難不死|大步檻過
大革新|大換血
大顆|大粒
大顆鑽石|巨鑽
大風雨|橫風橫雨
大餐|九大簋
大馬哈魚|三文魚
大高個兒|高腳七
大鬍子|鬍鬚公
大鹽|粗鹽
天之嬌子|當紅炸子雞
天九牌|天九
天冷時|天時冷
天剛亮|一天光
天壤之別|爭天共地
天大的本事|飛天本事
天天如此|日日如是
天天|日日
天底下|天腳底
天才亮|曚曚光
天打雷劈|畀雷劈
天旱|旱天
天曚光|曚曚光
天棚|天臺
天殺|天收
天氣不好|唔好天
天氣冷|天口冷
天氣冷的時節|凍天
天氣|天時
天氣很熱|天口焮
天氣悶熱|曀
天氣悶熱欲雨|焗雨
天氣晴朗|好天
天氣炎熱|天時暑熱
天涯海角|天腳底
天淵之別|差天共地
天熱時|天時熱
天生的歪脖子|側頭側腦
天生的笑臉|歡容
天真有趣|趣緻
天竺鼠|葵鼠
天臺|天棚
天色陰沈沈|陰陰天
天花亂墜|天花龍鳳
天花板|樓頂
天花|痲痘
天藍|湖水藍
天邊|天腳底
天陰陰|陰陰天
天馬行空|車天車地
天黑|入黑
太便宜|抵到爛
太值|抵到爛
太像|太似
太兇|太惡
太厲害|太叻
太可惜了|嘥晒
太多|多得滯
太大了|大過頭
太太|太
太好了|好得滯
太好|太叻
太妃糖|拖肥糖
太容易|容乜易
太小了|細過頭
太小|太細
太差|太水
太感謝了|唔該晒
太打攪了|騷擾晒
太接近邊線|太邊
太晚|太夜
太油膩|好腬
太熱了|熱過頭
太相像|太似
太空梭|穿梭機
太要不得|太不要得
太貴了|貴過頭
太過分|離晒譜
太長了|長拉拉
太陽下山|收熱頭
太陽|日頭
太陽曬着|日頭蕩蕩
太陽照射|曬
太陽眼鏡|太陽鏡
太陽穴|魂精
太陽鏡|墨超
太陽雨|白撞雨
夫之弟婦|阿嬸
夫人|師奶
夫妻倆|兩公婆
夫妻|公婆
夫妻離異|失婚
失信|甩底
失勢|沉
失去人的常性|唔係人噉品
失去機會|走雞
失去|甩
失去貞操的女人|爛番茄
失態|走光
失戀|甩拖
失手|錯手
失掉|唔見
失掉時機|走雞
失敗|仆直
失散|走散
失望|跌晒眼鏡
失期|甩期
失禮了|失禮
失禮於人|失禮
失策|錯見
失約|失拖
失足坐下|扽
失足|䟕錯腳
失面子|失禮
夷平|鏟平
夾克衫|飛機恤
夾克|飛機恤
夾塞兒|櫼隊
夾心人|做磨心
夾心餅乾|夾心餅
夾硬|夾粗
夾緊|逼
夾肢窩|胳肋底
夾腳拖|人字拖
夾衣|夾衲
夾衫|夾衲
夾襖|夾衲
夾道|冷巷
奇妙|蹺妙
奇形怪狀|怪形怪相
奇怪外形|怪樣
奇怪|離奇
奇特|騎呢
奇葩|怪雞
奇裝異服|油脂裝
奇計|八寶
奈何不了|咬唔入
奈何不得|冇奈何
奈何|出尺
奈及利亞|尼日利亞
奈米|納米
奉承|戴高帽
奏效|見功
奔忙|撲
奔|撲
奔波勞碌|頻頻撲撲
奔波忙碌|頻撲
奔波|頻撲
奔走|走趯
套上|錔
套交情|拉相好
套房|套間
套用|改實
套近乎|拉相好
套間|單位
套頭上衣|笠衫
套頭汗衫|笠衫
套頭的上衣|過頭笠
套頭的針織綫衣|笠衫
套頭衫|笠衫
套頭|過頭笠
奠基|打樁
奠好|打好
奧妙|竅妙
奧客|西客
奪目|搶眼
奪財產|搶財產
奮不顧身|奮身
女主人|事頭婆
女二房東|包租婆
女人再嫁|返頭嫁
女人|女
女人家|女人之家
女人樣|乸型
女傭人|褓姆
女傭|婆媽
女儐相|姊妹
女兒家|女仔之家
女兒|阿女
女士|女仔
女嬰|孲女
女子|女仔
女子為娼|落河
女孩兒|女仔
女孩|妹
女孩子|女仔
女孩子家|女仔之家
女學生|學生妹
女巫|鬼婆
女廁所|女界
女廚子|煮飯
女強人|嚦女
女性|女人
女性舞女大班|媽媽生
女性西洋人|番鬼婆
女戀人|女
女掌櫃|事頭婆
女朋友|女
女流氓|飛女
女演員|女優
女生|女仔
女用|女界
女警察|差婆
女賊|撈女
女里女氣的人|女人形
女阿飛|飛女
女騙子|撈女
奶奶|阿嬤
奶媽|濕腰
奶油|牛油
奶糖|拖肥
奶酪|芝士
奸人|奸仔
奸滑|奸狡
奸猾|奸狡
奸詐|奸狡
她|佢
她們|佢哋
好一會兒|一牌
好久不見|好耐冇見
好了一點兒|好少少
好了。|啦。
好事多磨|阿茂整餅
好事|諸事
好些日子|好日
好位置|好位
好佔人便宜|搵笨
好使|使得
好便宜|好抵買
好傳話|口疏
好像|好似
好像是|係啩
好價錢|筍價
好兆頭|好意頭
好出主意|吧喳
好出風頭|沙塵
好到極點|好得滯
好動|冇時閑
好勝者|一哥
好吃好住|好食好住
好吃|好食
好吃懶做|好食懶飛
好吃懶做的人|大食懶
好吃者|啄
好名字|好名
好味道|惹味
好命運|好命水
好喝酒|爛酒
好喝酒者|醉貓
好嗎？|咧？
好在|勝在
好壞搭配|隻褦隻
好天兒|好天
好奇|貪得意
好女兒|乖女
好好做人|立品
好好兒|好地地
好好|好地地
好孩子|好仔
好實惠|好抵買
好小|好細
好帥|威水
好幫助人|好衣食
好心腸|好好人
好打扮|姿整
好搬弄是非者|是非啄
好景短暫|三日香
好有好報|好心有好報
好朋友|死黨
好東西|正嘢
好東西留到最後|好物沉歸底
好棒|好叻
好極了|好到極
好|正斗
好歹|好醜
好滋味|好味
好炫耀|白霍
好爭第一|鳩屎
好爭論|包詏頸
好狗不擋道|好狗唔擋路
好狗不攔路|好狗唔擋路
好玩|得意
好用|使得
好相處|好相與
好看|啱睇
好端端|好地地
好笑|搞笑
好管閑事|八卦
好管閑事者|雞仔媒人
好精神|龍馬精神
好羞|醜甩耳仔
好脾氣|好相與
好色之徒|鹹濕佬
好色|咸濕
好色者|鹹蟲
好花錢|大使
好萊塢|荷里活
好處|着數
好說|好話
好說話兒|好使好用
好談論是非|吱喳
好讓|好等
好貨|貨面
好賭|爛賭
好賴也是|假假地都係
好走|好行
好轉|好返
好辦法|八寶
好運到來|走紅
好運|好彩
好運氣|當紅
好閏女|乖女
好青年|好仔
好鬧事者|屈尾龍
好鬧|反斗
好點了|好少少
如今|今陣
如何做|點搞
如何是好|點算好
如何|點
如來佛|如來佛祖
如廁|交水費
如意|勝意
如果|若果
如此一來|就係噉
如此|係噉
如此的話|就係噉
如此等等|乜乜物物
如狼般|狼
如膠似漆|糖黐豆
如願以償|心想事成
如願|心適
如願意償|得償所願
妄想|指倚
妒忌別人|眼熱
妒忌|呷醋
妓女|企街
妓女從良|跟佬
妓女領班|媽咪
妓院中的打手|龜爪
妖冶|妖孽
妖媚|姣
妖艷|鬼火咁靚
妖魅|攝青鬼
妙|㜺
妙手回春|明功
妙縱|縱
妙計|好橋
妞兒|妹仔
妥|掂
妥當|定當
妨礙人家好事者|電燈膽
妨礙公務|阻差辦公
妨礙別人做事|阻手阻腳
妨礙警察執行任務|阻差辦公
妨礙|阻
妯娌倆|兩嬸母
妯娌|嬏母
妹妹|細妹
妹子|妹仔
妺輩|妹
妻之兄|大舅
妻子捉丈夫的奸|踢竇
妻子的姘夫|老襟
妾生之子|插燒仔
姊妹花|雙妹嘜
姊姊|家姐
始末|頭尾
始終|首尾
姐兒|大姐仔
姐妹|絲打
姐|家姐
姑丈|姑父
姑且不論|姑勿論
姑兒|姑姐
姑娘家|女仔之家
姑媽|阿姑
姑母|姑姐
委婉說法|飲藥
委屈|淤
委託|搭
姘夫|契家佬
姘婦|契家婆
姘頭|契家婆
姨侄女|姨甥
姨侄|姨甥
姨兒|姨媽
姨太太|二奶
姨夫|姨丈
姨|姨仔
姨姨|阿姨
姨媽|姨媽
姨母|姨媽
姨父|姨丈
姿勢|甫士
姿態風度|動靜
威信|牙力
威嚴|恁威
威風一下|威下
威風八面|威到痺
威風|威水
娃娃|公仔
娘兒|姑姐
娘娘腔|女人形
娘家|外家
娛樂|耍樂
娛樂行業|娛樂圈
娶娘婦兒|娶老婆
娶媳婦|娶新抱
娶親|娶老婆
婁|倒瓤
婆婆媽媽|師奶
婆婆|家婆
婚宴|新婦酒
婚禮上的酒宴|喜酌
婢女|妹
婦人家|女人之家
婦人|師奶
媒人|大葵扇
媒妁|大葵扇
媒婆兒|大葵扇
媒婆|大妗姐
媒婆子|大葵扇
媒氣管道|媒氣喉
媒煙灰|媒屎
媳婦兒|心抱
媳婦|新婦
媽媽|阿媽
媽祖|天后
嫁不出去|楔灶罅
嫁妝|妝嫁
嫂嫂|阿嫂
嫂子|阿嫂
嫉妒|呷醋
嫌隙|拗撬
嫖妓女|叫雞
嫖妓|滾紅滾綠
嫖客|嫖友
嫡母|大媽
嫡親|親生
嫩姜|子姜
嫩莖|薳
嫩薑|薑芽
嫩雞|童子雞
嬌柔|嬌嗲
嬌氣|貴細
嬌滴滴|嬌嗲
嬌生慣養|身嬌肉貴
嬌貴|貴細
嬰兒|蘇蝦仔
嬰孩|啤啤
嬸兒|阿嬸
嬸嬸|阿嬸
嬸子|阿嬸
嬸母|阿嬸
孌童|契弟
子兒|仙屎
子女|仔女
子女們|班仔女
子孫|仔孫
子孫後代|後手
子母扣兒|啪紐
子雞|童子雞
𤠣子|馬騮
孑孓|紅蟲
孔洞|窿
孔|眼
孔雀藍|姣婆藍
孕婦|大肚婆
字元|字符
字墨|筆墨
字紙簍兒|字紙籮
字紙簍|字紙籮
字體的結構|格局
存儲|儲埋
存取|接達
存心|立心
存款|入數
存水|儲水
存錢|儲錢
孝幛|孝幃
孝服|服
孝順|孝義
孤單|孤單單
孤注一擲|盡地一煲
孤獨|孤單單
孤零零一人|冇人冇物
孤零零|孤仃仃
孩子|仔女
孩子年幼|仔細
孩子氣|大唔透
孩子都年幼|仔細女嫩
孫子|孫仔
孫悟空|馬騮精
孵|菢
學問|字墨
學徒|學師仔
學得|識得
學會|學識
學期將近結束時|學期尾
學期末|學期尾
學期終結|學期尾
學校|學堂
學校的舊稱|學堂
學生|學生哥
學生鞋|返學鞋
學習|學
學舌|學是非
學術流派|家
學識才幹|料
學長|師兄
孿生姑娘|孖女
孿生子|孖仔
孿生|孖生
它|佢
它們|佢哋
宅在家|黐家
宇宙飛行員|太空人
守口如瓶|密實
守夜|睇更
守宮|檐蛇
守活寡|守生寡
守舊|古縮
守衛|看
守規矩|老實
守護|看
守財奴|惜荷包
守門員|龍門
安全|保安
安全地|保安噉
安地列斯|安的列斯
安地卡|安提瓜
安心|心適
安排位置|執位
安排好|算好
安於本份|做慣乞兒懶做官
安樂|一樂也
安樂湊孫|含飴弄孫
安閑|安樂
安靜|靜
完了|玩完
完全一樣|絕冇二樣
完全不知道|呃晒
完全依照|跟足
完全像|十足
完全地|完全噉
完全|完全
完全毀掉|渣都冇
完全沒有關係|三唔識七
完全裸露|光脫脫
完全贊成|舉腳贊成
完善|整晒
完工|起貨
完成任務|起貨
完成得很好|妥當
完成|搞掂
完整|齊晒
完|晒
完畢|晒
完美|冇得彈
完蛋了|係咁大
完蛋|凍
宏都拉斯|洪都拉斯
官位高|大粒
官兒大|大粒
官司|官非
官話|粵語
官話（臺灣）|粵語（香港）
定做衣服|度身做衫
定時供水|制水
定罪|入罪
定金|定銀
定錢|定銀
客人|人客
客家話|挨話
客廳|大廳
客戶|客仔
客氣|拘
客源|客路
客滿|爆棚
客艙|座艙
宣傳|催谷
宣揚|賣報紙
宣|鬆婄
宰|斬
害人害己|害人害物
害人|靠害
害得沒有辦法|臘起
害羞|怕醜
害臊|羞家
害苦了別人|累人累物
害苦別人|累死人
害青光眼|發青光
害|靠害
家中吵吵鬧鬧|家嘈屋閉
家中|屋企
家中瑣事|家頭細務
家中自製|家
家人|屋企人
家伙|友仔
家具|家私
家務事|家頭細務
家務|家頭細務
家喻戶曉|街知巷聞
家境富裕|家肥屋潤
家境愈來愈窮|陰乾
家姑老|老姑婆
家居|屋企
家常菜|街坊菜
家底厚|背脊厚
家底|根底
家庭主婦|師奶
家庭作業|家課
家庭|屋企
家庭支柱|仔細老婆嫩
家庭瑣事|家頭細務
家族之間講和|擺和頭酒
家業|根底
家無寧日|家嘈屋閉
家無隔宿之糧|餐搵餐食
家用陶製小臼|砂盆
家畜的小腸|粉腸
家禽的一種|雞
家蠶|蠶
家裏人|屋企
家裏|屋企
家裏的瑣碎事務|家頭細務
家裡吵吵鬧鬧|家嘈屋閉
家裡|屋企
家鄉|鄉下
家醜不出外揚|家醜不出外傳
家釀的一種醋|臭屁醋
家鼠|坑渠老鼠
容光煥發|好氣色
容忍|忍氣
容易上火|好熱氣
容易哭|眼坑淺
容易|易
容易激動|薄皮
容易相處|好相與
容易辦的事|小兒科
容易辦|閑閑哋
容易通過|順攤
容易配襯|百搭
容許|畀
宿怨|仇口
宿舍|舍堂
寂寞|靜局
寂靜|靜英英
寄住|掛單
寄居|寄住
寄生蟲|蛀米大蟲
密切配合|拍硬檔
密商|密斟
密密匝匝|密口
密密實實|實質質
密密麻麻|密質質
密實|密淨
密封|密口
密淨|結
密談|密斟
密鑰|密碼匙
密鑰對|配對密碼匙
密雲欲雨|曀
富二代|二世祖
富家子|二世祖
富有|沓水
富翁|水喉
富貴相|貴氣
富餘|凸
寒冷|凍冰冰
寒磣|難睇
寒雀|禾花雀
察覺|醒水
寡味|木獨
寡婦|寡婆
實力|硬淨
實在是|真係
實在|正一
實實在在|實牙實齒
實惠|抵
實測|實試
實話實說|有碗話碗有碟話碟
實際上|實情
實際上的|實然
實際原因|解究
實際去做|坐言起行
實際|實
寧可|寧願
寧靜|靜
寧願|宜得
寫下|寫低
寫單|睇數
寫意|盞
寫稿|爬格仔
寫著|寫住
寫記號|打交叉
寬大|闊
寬敞|闊落
寬暢|闊落
寬短褲|牛頭褲
寬米粉條|沙河粉
寬粉條|河粉
寬綽|舒展
寬肩膀|奓膊
寬|闊
寬闊|闊落
寬面|闊封
寵壞|縱壞
寵|縱
寶特瓶|膠樽
寶貝|心肝椗
寶貴|矜貴
寸口|脈門
寸土寸金|寸金尺土
寺廟|庵堂
寺院|寺門
封住|懫住
封閉|密籠
封閉形的指紋|籮
封閉得嚴密|密實
射球|抽射
將來|第時
將到|臨到
將就|相就
將快|快將
將會|會
將楔子打入|打櫼
將物品倒過來|打倒椗
將要|就嚟
將貨物寄存棧房|寄棧
將近|成
將頭撞向牆壁|撼頭埋牆
將鼻涕用力排出|擤
專家|行尊
專店|專門店
專心|畀心機
專心致志|沓埋心水
專業範圍|瓣
專登|一登
專程|一登
專門出謀劃策的人|扭計師爺
專門|專登
專門特|一登
尊夫人|太座
尊姓大名|貴姓名
尊貴|矜貴
尋找|揾
尋找"|揾字
尋求協助|揾幫手
尋求|搏
尋覓|搵
尋釁|找晦氣
對不住|虧負
對不對|啱唔啱
對不起|對唔住
對了！|啱呀！
對了，|話時話，
對事情的判斷能力|眼水
對人的吩咐|笛
對人說話的態度|聲氣
對人關心|有心
對付|找晦氣
對付著|求其
對兒|孖
對勁兒|係路
對幹|互插
對得起|對得住
對手|手腳
對抗|對撼
對某人或事害怕|窒
對比|比對
對氣血不利|敗血
對水|浸水
對照|比對
對眼兒|鬥雞眼
對眼|合眼
對眼睛有好處|養眼
對聯的橫披|橫額
對與否|係唔係
對著|對住
對著幹|對撼
對過兒|對開
對過|對開
對面|對出
對頭|係路
導向竿|盲公竹
導引棒|盲公竹
導致|引致
導覽|導航
小不點兒|豆丁
小丫頭|妹釘
小九九|九因歌
小事一件|少少事
小事一段|小兒科
小事兒|小兒科
小事|小小嘢
小事情|脂麻綠豆
小事相持|鬥負氣
小人兒|公仔
小人書|公仔書
小人精|老人精
小休|小息
小伙子|後生仔
小伙計|後生
小便不暢|屙遏尿
小便|放輕
小個子|細個
小偷|三隻手
小偷兒|賊仔
小傢伙|塞豆窿
小傻瓜|傻仔
小兄弟|後生
小兒子|孻仔
小兒學步貌|趁
小兒學舌|學是非
小兒游戲之一|跳飛機
小兒游戲|跳大海
小兒用驅蟲藥|寶塔餅
小兒的學步車|學行車
小公狗|狗牯
小公貓|貓仔
小凳子|凳仔
小刀兒|刀仔
小刀|刀仔
小刀鋸大樹|刀仔鋸大樹
小刀鋸斷大樹|刀仔鋸大樹
小勺兒|匙羹
小叔子|叔仔
小口地喝|慢慢渳
小吃|小食
小吃店|小食部
小吃攤|大牌檔
小同學們|同學仔
小商店|士多
小喇叭|喇叭仔
小器|孤寒
小器鬼|鐸叔
小型公共汽車|小巴
小型杆秤|厘戥
小型柿子|雞心柿
小型汽車|小巴
小型測驗的考卷|小測卷
小型的扁沙鍋|煲仔
小型直尺|間尺
小型|蚊型
小型輪船|小輪
小塊銀子|碎銀
小壞蛋|衰仔
小女孩子|阿姑
小女孩|細路女
小妞兒|靚妹
小妹妹|妹妹仔
小姐|姑娘
小姑兒|細姑
小姑姑|姑姐
小姑娘|姑娘仔
小姑子|姑仔
小姑|細姑
小姨子|姨仔
小姨|細姨
小娃娃|細蚊仔
小婆子|細婆
小嬰兒|臊蝦仔
小嬸嬸|孻嬸
小嬸子|孻嬸
小子|僆仔
小孩不怕疼|韌皮
小孩不聽話|韌皮
小孩兒|細路
小孩子玩打仗|打仗仔
小孩子|細路仔
小孩玩的滑梯|瀡板
小孩生日|長尾巴
小孩|細佬
小孩能走路了|脫手離佗
小學生|學童
小家子氣|小家
小小不言|小小的
小小年紀|人仔細細
小小|的的骰骰
小工|細工
小巧玲瓏|的式
小巧|菂息
小巫見大巫|蚊髀同牛髀
小巷|冷巷
小平頭|平頭裝
小年|小造
小床|床仔
小店鋪|鋪頭
小弟|細佬
小徒弟|學師仔
小得失|小兒科
小心些|因住嚟
小心交友|帶眼識人
小心|因住
小心愛護|儆惜
小心眼兒|小器
小心著|顧住
小意思|溼溼碎
小手指|手指尾
小手提籃子|籮
小抄兒|貓紙
小抄|貓紙
小拇指|尾指
小拇趾|腳趾尾
小指|尾指
小指頭|手指尾
小提包|手袋
小攤兒|小攤檔
小攤子|小攤檔
小數點兒|定點
小於|細過
小時|個鐘
小時候|細時
小時工|鐘點女傭
小朋友|細民仔
小木碗|甌
小板凳|矮凳仔
小棚|鴨寮
小機靈|醒目仔
小母貓|貓女
小母雞|雞項
小毛賊|賊毛
小氣|孤寒
小水窪|氹
小汽車|私家車
小河|涌
小泡|𦢊
小流氓|飛仔
小測驗|小測
小牌子|水牌
小牛|牛仔
小牛犢|牛仔
小狗兒|狗仔
小猴子|馬騮仔
小玩偶|公仔
小玻璃球|波子
小珠兒|珠仔
小珠子|小珠仔
小瓦罐|罌
小甘蔗|竹蔗
小甜餅乾|曲奇
小甜餅|曲奇
小男孩|哥仔
小男孩的生殖器|鳩朘
小白兔|兔仔仔
小白臉|削仔
小白菜|白菜仔
小皮包|手袋
小看|睇輕
小睡|瞌
小矮個兒|三寸釘
小碗|兜
小碼頭|磯
小算盤|縮數
小箱子|笈
小簍子|籮
小米兒|狗尾粟
小粒|細粒
小紅紙包|利市封
小老婆|妾待
小聰明|走精面
小聲|細聲
小聲點|細聲啲
小背心|吊帶
小胖子|肥仔
小胡同|冷巷
小腳女人|纏腳娘
小腸串氣|小腸氣
小腸疝氣|小腸氣
小腿肚子|腳瓜囊
小腿肚|腳䯑䯖
小腿|腳肚
小腿骨|腳骨
小舅子|舅仔
小舌兒|吊鐘
小舌|吊鐘
小舌頭兒|吊鐘
小船兒|艇仔
小船|艇仔
小艇|艇仔
小色鬼|麻甩仔
小芥菜|芥菜仔
小花童|花仔
小菜一碟|小兒科
小菜兒|小兒科
小蓋章|印仔表
小藤箱|藤笈
小蟲|蟲蟲蟻蟻
小街小巷|橫街窄巷
小街|橫街
小角色|卒仔
小解|放水
小豆甜粥|紅豆沙
小豆|赤小豆
小豬|豬仔
小貓|貓仔
小費|貼士
小賣店|士多店
小賤人|衰女
小路|徑
小轎車|房車
小辣椒|指天椒
小道消息|貼士
小鈔|散紙
小鈴兒|噹噹
小鈴聲|鈴
小鈴鐺|鈴鈴
小銅鈴|鋃鋃
小鋪|鋪頭
小鑷子|眉鉗
小閣樓|閣仔
小閨女|細路女
小陶罐|罌
小陷阱|三腳凳
小隻|細隻
小雄貓|貓仔
小雌貓|貓女
小雞雞|不周
小雞|雞仔
小青年|哥仔
小題大作|巴閉
小食品|茶果
小食店|糖水舖
小食|茶果
小飯鋪|食物館
小館|茶居
小馬兒|馬仔
小馬|馬仔
小鬼|細鬼
小魚兒|魚仔
小魚|魚仔
小鳥|雀仔
小麥粉|麵粉
小黃魚|黃花筒
少不了|唔少得
少不得|唔少得
少塊肝|少塊潤
少女|後生女
少奶奶|少奶
少年|後生仔
少有|好少何
少東家|少東
少油膩|清
少爺|少
少許|些少
少說也有|閒閒地
少量|些少
少量地倒|斟
少量的汗|微汗
少點|少啲
尖嘴薄舌|牙尖嘴利
尖尖|尖不甩
尖聲叫|鬼聲鬼氣
尖酸刻薄|澀滯
尖頭小艇|螞螂艇
尖頭鋤|鶴嘴鋤
尖頭鎬|啄
尚未了結的事情|手尾
尚未|未
尚比亞|贊比亞
尤其|零舍
就一次|一次過
就事論事|有碗話碗有碟話碟
就位|埋位
就在|嚟緊
就座|埋席
就是個|正一
就是|即係
就會耍嘴皮子|得把口
就看|爭在
就著吃|送
就要|就嚟
就診|睇醫生
就這樣|係噉
就這麼|係噉
就飯吃|送飯
就飯|撈飯
尷尬|面懵
尺子|間尺
尺寸|哂屎
尺碼|晒士
尻骨|尾龍骨
尼姑|師姑
尼姑庵的庵主|家持
尼日|尼日爾
尼龍絲|魚絲
尼龍網袋|魚絲袋
尼龍編織袋|蛇皮袋
尼龍襪|原子襪
尾巴|尾
尾數|數尾
尾椎骨|尾龍骨
尾聲|晒尾科
尾隨|吊尾
尾骨|尾龍骨
尿尿|溺尿
尿布|尿片
尿牀|攋尿
尿片|屎片
尿臊味|胺
尿臊氣|臭胺
局促|淺窄
局盤|鋪
局|鋪
屁滾尿流|屎淋尿瀨
屁眼兒|屎窟窿
屁股|屎窟
屁股的俗稱|囉柚
屁股眼|屎胐窿
屄|膎
居住環境|家居環境
居心|立心
居然|夠膽死
居者有其屋|居屋
屈服|認低威
屋子|齋
屋檐下之處|檐口
屋檐下|檐口
屋檐|檐口
屋簷|簷篷
屋裏的陳設布置|格局
屋頂|屋蓋
屋頂的一列瓦|桁
屌|膦
屍體|屍身
展示|騷
展開|唞
屠宰|劏
屢見不鮮|數見不鮮
層|浸
屬下|旗下
屬於自己個人的東西|私伙
屬於雙方|兩家
山洞|山窿
山溝|山坑
山澗|山坑水
山瑞鱉|山瑞
山羊|草羊
山羊鬍子|羊咩鬚
山腰|半山
山葵|華沙卑
山藥|淮山
山雞|野雞
岌岌可危|岋岋愩
岔亂歌柄|劖亂歌柄
岡棯|棯仔
岳家|外家
岳母|外母
岳父|外父
峰|峯
崩潰|冧
崩裂|崩
崴了腳|屈到腳
崴|戾
嵌|崁
嶄新|新簇簇
川燙|淥
巢穴|竇口
巢|竇
工人|工友
工作午餐|商務午餐
工作|工
工作輕鬆清閑|他條
工作面試|見工
工具人|觀音兵
工具|架撐
工匠|手作仔
工友|校工
工地|地盤
工業用油|油
工程人員|師傅
工藝|人工
工資|人工
工資單|糧單
工運|工業行動
工錢|人工
工頭|科文
左右|上下
左右刁難|刁喬扭擰
左右四鄰|隔離鄰舍
左挑右選|左揀右揀
左撇子|左撓仔
左旋螺紋|倒牙
左轉|轉左
左進右出|車水過田
左邊兒|左手便
左邊|左便
左鄰右舍|隔籬鄰舍
巧克力|朱古力
巧克力渣兒|朱古力碎
巧合|巧
巧妙|竅妙
巨大的石斑魚|龍躉
巫師|南無佬
差一人|爭隻腳
差一等|差一皮
差一點兒|差一皮
差一點|差少少
差一點點|差少少
差不多了|七七八八
差不多|得
差之千里|爭成條墟
差別|爭別
差劣|水汪
差勁|苴
差少許|差一皮
差強人意|麻麻哋
差得遠|未有耐
差|苴斗
差錯|漏罅
差點兒|爭啲
差點|咁滯
己經|經已
已修改|改着
已儲存|記妥
已刪除|刪着
已加入|加着
已安裝|安裝着
已封鎖|封着
已建立|開着
已斬開|斬件
已組配|設着
已經下水|洗濕個頭
已經去世|死鬼
已經|經已
已經被|經已
已過|過着
已選取|揀着
已選的|揀中嘅
已關閉|閂着
巴不得|宜得
巴唧|劈叭
巴布亞紐幾內亞|巴布亞新畿內亞
巴掌|手板
巴望|恨
巴比通|巴比通
巴結|托大腳
巴貝多|巴巴多斯
市井之徒|街市仔
市場上|市面
市場不景氣|市道低迷
市場所渴求|渴市
市場|街市
市民|普羅大眾
市集|墟
布丁|布甸
布吉納法索|布基納法索
布屑|布碎
布幔|布障
布拉吉|衫裙
布拉腸粉|拉腸
布林|邏輯
布樣子|布辦
布穀鳥|咕咕雀
布袋傀儡戲|鬼仔戲
布製的腰帶|圍帎
布里敦|不列塔尼
布鞋|懶佬鞋
布頭兒|布碎
帆布喉|滅火喉
帆|艃
希奇古怪|鬼五馬六
希望不大|水汪
希望|冀望
希望我好|想我好
帛琉|帕勞
帥！|正！
師父的師父|師公
席地而睡|打地鋪
帳目|數
帶來厄運或壞名聲|佗衰
帶來|帶埋
帶個話兒|寄聲
帶刺兒|有骨
帶勁|夠勁
帶大|湊大
帶孩子|湊仔
帶孩子的女人|湊仔婆
帶小孩|湊仔
帶強烈旋轉的球|篩波
帶條紋|間條
帶殼炒熟的花生|鹹脆花生
帶犢兒|挽油瓶
帶疏眼的器皿|篱
帶糖的水|糖水
帶草的碗狀泥塊|草皮
帶著|掕埋
帶衰|馱衰
帶進|帶入
帶釘狀物|釘
帶領|揸大旗
帶頭人|頭
帶頭幹某事|扯頭纜
帶頭|撦頭纜
常|周時
常來往|行得埋
常例|例牌
常常|好多時
常年興旺|周年旺相
常用|用開
常言說得好|開講有話
常言道|開講有話
帽帶|帽襻
帽蒂|帽菂
幅寬|封
幫人講話|幫口
幫個忙|幫下手
幫助你|幫到你
幫助|幫
幫助您|幫到閣下
幫口|堂口
幫家裡省錢|慳家
幫忙|幫手
幫忙的人|幫手
幫手|二手
幫派組織的單位|堂口
幫着照看|幫眼
幫着看|幫眼
幫着評價|幫眼
幫着鑒定|幫眼
幫著看看|幫下眼
幫閑|磅友
平信|平郵
平口褲|孖煙通
平均分配|分豬肉
平均分開|分中
平均|拉勻
平塗|蕩
平安無事|冇事
平常|平時
平底鍋|罉
平息|擺平
平手|打和
平整|帖服
平日或有空閑的日子|閑日
平易近人|好相與
平木器|刨
平民化|大件抵食
平白無故|冇端白事
平臺|天臺
平衡|戥勻
平鋪|攤
平靜|定
平頭|平頭裝
年代久遠|古老十八代
年代久遠的車|老爺車
年初三|赤口
年初|年頭
年多|年幾
年富力強|當年後生
年幼|細個
年底|年尾
年庚|年生
年成|時年
年根兒|埋年
年根兒底下|挨年近晚
年紀大|七老八十
年紀小|細個
年紀很小|細細個
年紀輕輕|後生細仔
年級|年班
年終|歲晚
年終獎金|年尾花紅
年終竭塘而漁|刮塘
年老糊塗的人|老懵懂
年貨|年宵嘢
年輕人|後生仔女
年輕小伙子|花靚仔
年輕|後生
年關時|挨年近晚
年青人|後生仔
年頭不好|唔好世界
年頭兒|時年
年齡小|人仔細細
年齡|歲口
并|擸
幸好|好在
幸災樂禍|戥興
幸虧|好彩
幸運|好彩
幹不了|攪唔掂
幹什麼|做乜
幹嗎|使乜
幹嘛|做乜
幹工作|做工夫
幹得了|做得
幹掉|做低
幹木工活|鬥木
幹正當行業|做正行
幹活兒|做工夫
幹活兒手重|重手
幹活的工具|架撐
幼子|細仔
幼小的婢女|妹仔丁
幼小|香雞
幼弟|么弟
幼稚|唔臭米氣
幼稚無知|唔臭米氣
幼雞|雞僆
幽悶|悶
幽默|生鬼
幾乎|幾回
幾乎沒有|冇乜滯
幾乎趕不上|舋杪
幾個|好幾
幾個好朋友|三五知己
幾個鐘頭|幾個鐘
幾內亞比索|畿內亞比紹
幾內亞|畿內亞
幾口|幾下
幾天|幾日
幾小時|幾個鐘
幾許|幾多
幾|零
幾點鐘|幾多點
床上用品的總稱|床鋪被席
床單|被單
床墊|床褥
床底下|床下底
床底下的空間|床下底
床架|行床
底下|下低
底兒朝上|打倒椗
底子虛|虛底
底片|相底
底細|根底
底褲|短褲
底部|篤
店員|伙記
店|舖
店舖|舖頭
店鋪所佔的位置|鋪位
店鋪掌櫃|坐櫃面
店鋪每晚結賬|埋櫃
店鋪經理|事頭
店鋪|鋪頭
店面|舖位
度數|度
度過冬天|過冬
度量衡|量度
座位|位
庫存|貨存
庵寺|齋堂
庶母|細姐
康復|復康
庸庸碌碌|胡胡混混
庸醫|黃綠醫生
廁坑|屎坑
廁所|屎坑
廉價出售|平沽
廉價|平
廉價飲食攤子|大牌檔
廚具|煮飯仔
廚子|候鑊
廚師|候鑊
廚房|下間
廝殺|開片
廟宇|庵堂
廢人|廢柴
廢棄物|廢物
廢棄|頹
廢物|廢柴
廢紙簍|字紙籮
廣告|招紙
廣州|省
廣州話|省城話
廣式餛飩|雲吞
廣式香腸|風腸
廣東名菜|鹽焗雞
廣東大白菜|黃芽白
廣東省|省
廳中間供的神位|地主
延到|褪到
延期|押後
延誤了時機|甩期
延誤了預定日期|甩期
延長線|拖板
建房子|起屋
建房|起屋
建構|建立
建立好品行|立品
建築工人|三行佬
建築工地|地盤
建築設計師|則師
建築|起
建議|話
建|起
弄一些噱頭|搞搞新意思
弄一弄|攪一攪
弄不懂|搞不懂
弄不明白|搞不明
弄不清楚|矇查查
弄傷|整損
弄到|搞到
弄垮|打低
弄壞|搞涴
弄妥|搞掂
弄巧成拙|因加得減
弄平衡|戥
弄幾|整幾
弄幾道菜|整返幾味
弄彎使斷|屈
弄彎|屈
弄得不像話|攪到唔湯唔水
弄得了|攪掂
弄得|搞成
弄得這麼嚴重|攪到咁大鑊
弄炊|煮食
弄皺|起褶
弄破|整爛
弄碎|茸
弄糟了|瓜老襯
弄糟|泓
弄|舞
弄跨|玩殘
弄透|玩殘
弄錯了|搞錯
弄錯|攪錯
弄髒|攪涴
引人注意|起眼
引人注目|顯眼
引人發笑|惹笑
引伸為話語|偈
引子|引
引導陰魂上路|開路
引火燒身|周身蟻
引火|透火
引起|累事
弟兄|巴打
弟弟|細佬
弱點|痛腳
張三|阿勝
張口結舌|擘大口得個窿
張大其事|巴閉
張大眼睛|瞠大對眼
張掛|繃
張貼的廣告|招紙
張開口|擘大口
張開嘴|擘大口
張開|擘開
張開眼睛|擘大眼
強人|嚦仔
強人所難|牛唔飲水點撳得牛頭低
強使|扤
強制|夾硬
強摘的瓜不甜|牛唔飲水點撳得牛頭低
強盜船搶劫|扒長龍
強盜|賊佬
強|盞
強而有力的反駁|力駁
強行|夾硬
強行推動|鏟
強行擠入|逼
強詞奪理|死硬撐
強辭奪理|牙譫譫
強迫|迫
強龍不如地頭蛇|猛虎不及地頭蟲
强行|硬弸弸
彆扭|刁喬扭擰
彈出|彈
彈子|波子
彈性好轉|彈手
彈球兒|打玻子
彈簧床|蹦床
彌月設宴|擺姜酌
彌補|補數
彎彎曲曲|九曲十三彎
彎曲|攣弓
彎曲的部分|彎
彎腰|烏低身
彗星|掃把星
形勢不妙|勢色不對
形勢不對|勢色不對
形勢|勢色
形勢豁然好轉|一天光晒
形單影隻|孤清清
形如梅花的小點|梅花點
形影不離|糖黐豆
彩棚|彩門
彩票開彩|開標
彩色|顏色
彩頭|意頭
影像和音響|影音
影像|錄像
影壁|照壁
影響別人聲譽|佗衰
影響很大|好傷
彳部|雙企人
彼此彼此|大家噉話
彼此方便|大家好做
彼此有仇|爛口爛面
往上|上
往下打|扻
往回|翻轉頭
往往|每每
往後退|褪後
往昔|舊時
待慢|待薄
待會兒|一陣間
很一致|好歸一
很下賤的相貌|乞兒相
很不好意思|很瘀
很不好過|好唔掂
很不尖|倔擂槌
很不用心|好唔上心
很不錯|好正
很不高興|好唔開心
很丟人|好醜怪
很丟臉|好醜怪
很亮堂|光劖劖
很仔細|好有手尾
很便宜|抵到爛
很偏的門路|窿罅
很像|似足
很像樣兒|好好睇睇
很光亮|光猛
很冷|刺
很厲害|犀飛利
很合得來|行得好埋
很吵|很嘈
很嘈雜|好嘈
很嘮叨|好嘮嘈
很噁心|好核突
很多問題|問題多多
很多|大把
很多小動作|搞搞震
很多很多|多籮籮
很多新聞|新聞多多
很多方面|好多瓣
很多時候|好多時
很大|加大碼
很|好
很好吃|好好食
很好|好正
很好的人|好人好姐
很好笑|好搞笑
很好色|好鹹溼
很威風|好威
很孱弱|好孱
很容易做的工作|懶佬工夫
很容易|容乜易
很容易辦到的事|閑事
很實惠|埋腩
很專心|好心機
很對|好着
很小的嫌隙|隔夜仇
很小|細細
很少份量|少少
很少|少少
很尖|尖不甩
很尷尬|很瘀
很平常|好閑
很幸運|很好彩
很得體|好好睇睇
很心疼|好肉痛
很快就回轉|屈尾十
很快|快過打針
很快改變主意|屈尾十
很悶|好焗
很悶熱|好焗
很想得到|欿
很憤怒|好焮
很懶惰的人|蛇王
很懸|牙煙
很抱歉|唔好意思
很擁擠|迫到震
很擠迫|迫到震
很散漫|好迆
很整齊|葺齊
很新奇|好好奇
很新|新簇簇
很早以前|大早
很早|倒屎咁早
很早就|老早就
很明亮|光劖劖
很時髦|好派
很晚了|很晏
很晚|夜
很普通的事|閑事
很會|得
很有派頭|大派
很有看頭|噱頭十足
很有耐心|好心機
很有耐性|好心機
很有膽量|膽生毛
很有起色|風生水起
很有趣|過癮
很有運氣|很好彩
很有錢|夠水頭
很柴|好乾漮
很棒|好㔹
很模糊|好麻茶
很正確|好着
很死|淰
很氣派|威猛
很滑溜|滑嘟嘟
很漂亮|好好睇睇
很炎熱|很曬
很烈|好猛
很爽快|好潎脫
很狼|好狼胎
很猛|好狼胎
很生氣|嬲爆爆
很瘦的人|瘦骨仙
很真誠|很真
很短的時間|一時三刻
很短|短切切
很稠密|穠
很糊塗|好冇搭晒
很老的樣子|老嚙嚙
很聰明|好惺
很能吃苦|幾禁捱
很能喝酒|飲得
很能|得
很能打|好打得
很自由|冇拘冇管
很臭|臭崩崩
很薄|薄切切
很蠻橫|好狼戾
很衝|猛
很誇張|好交關
很費神|好譅氣
很貼切|很對題
很賠本兒|好蝕底
很軟|軟腍腍
很遠|冇雷公咁遠
很遲|好晏
很配|登對
很酷|好型
很重|重耷耷
很陳舊|古老十八代
很難侍候|㤿憸腥悶
很難堪|很瘀
很難看|好醜樣
很零碎的票子|濕柴
很順利|佮佮掂
很香|好聞
很髒的人|污糟貓
很體面|好好睇睇
很高興|好開心
律師事務所|律師樓
律師|狀師
律師證明|律師紙
後代|香燈
後來|後尾
後備|執二攤
後兒|後日
後半晌|下半晝
後半晌兒|下晝
後天上午|後朝
後天|後日
後天早上|後朝
後天晚上|後晚
後妻|後底婆
後尾兒|後尾
後|屘
後掛車廂|拖卡
後晌兒|下晝
後果不佳|好傷
後父|後底爺
後爹|後底爺
後續|手尾
後背|背脢
後腦勺兒|後尾枕
後腦勺|後尾枕
後腳兒|後腳
後花園|後園
後衣架兒|後尾架
後補|執二攤
後足|後腳
後輩|子侄
後退|褪後
後遺症|手尾
後邊兒|後便
後邊|後尾
後門兒貨|老鼠貨
後院|後園
後面|後底
後頭|後便
徑直|直程
徒勞無功|混吉
徒勞|賺攪
徒有形式|乾
徒然|賺得
得不到利益|冇料到
得不到|唔得
得了|罷喇
得到大好處|掘大藕
得到好處|得食
得到|拿到
得勢不饒人|寸人唔使本
得夠戧|得交關
得妥|得掂
得很|到飛起
得很厲害|得好緊要
得心應手|靈擎
得志|封相
得意|得敕
得意忘形|得戚
得意洋洋|得戚
得意而話多|好唱口
得感冒|傷風添
得手|得記
得把嘴|得把口
得|攪掂
得物無所用|捉到鹿唔識脫角
得疳積病|生積
得病|唔精神
得相當長的時間|有一牌
得知|得悉
得罪人的人|醜人
得罪|得失
得虧|好得
得食|得米
徘徊|揗
從中取利|打斧頭
從事|做
從來|不摟
從來不會|冇話
從來就|不溜
從來沒有|冇話
從前的時候|舊陣時
從前|舊時
從國外進口|嚟路
從容|佗佻
從容鎮定|氣定神閑
從小到大|由細到大
從小|自細
從底下托|兜
從從容容|佗佗佻佻
從早到晚|一日到黑
從|由
從親|疏堂
從過去到現在|嚟
從零開始|拆棚做過
從頭做起|從低做起
復原|揾返
復查|跟
復活|返生
微微笑|陰陰笑
微笑|微微嘴笑
微笑的樣子|笑微微
微鹹適口|淡口
德性|衰衰噉
德行樣兒|貓樣
德高望重之人|大哥大
徹夜不眠|捱更抵夜
徹夜|通宵
徹底治癒|斷尾
徹底痊癒|斷尾
徹底|透
徹|通
徽章|襟章
心上|心入面
心不在焉|水過鴨背
心不旁騖|沓埋心水
心中不寧|囉囉攣
心中不舒服|唔落膈
心中堵得慌|哽心
心中很有策略或主意|滿肚密圈
心中情願|心甘
心中憋悶|慍悶
心中憋氣|條氣唔順
心中掛念|心掛掛
心中明白|心知肚明
心中有底|有分數
心中有數|有分數
心中氣不平|條氣唔順
心中氣悶|翳氣
心中滿足|心足
心中牽掛着|心掛掛
心中痛快|心甜
心中的嫌隙|計帶
心中鎮定|倓定
心中驚怕|忳
心亂如麻|立立亂
心事|心水
心動不已|心㤢㤢
心動|心㤢
心境從容|倓定
心大心細|把心唔定
心字旁|企心邊
心安理得|袋袋平安
心定|定過抬油
心思|心機
心思旁騖|多心
心思細密|心水清
心急|喉急
心情不好|冇心機
心情不安寧|囉攣
心情不舒暢|條氣唔順
心情幽悶|心搕
心情很舒暢|條氣順晒
心情愉快|他佻
心情抑鬱|翳
心情極佳|心情極靚
心情極好|心情極靚
心情|氣
心情煩悶|悶
心情緊張|一額汗
心情舒暢|氣順
心意|心水
心愛|心水
心愛的|心水
心慌|媌神
心懷不軌|有鬼
心懷鬼胎|有鬼
心智|心水
心服口服|保你大
心機|機心
心氣高|心頭高
心滿意足|心足
心火旺|心火盛
心灰意冷|心灰
心灰意懶|心淡
心焦|心搕
心照不宣|心知肚明
心煩|心搕
心煩意亂|頭大
心疼|肉𣤩
心疼錢|骨痺
心痛|心悒
心癢癢|心郁郁
心直口快|直腸直肚
心眼兒壞|唔好心
心眼兒多|心多
心眼兒|腦
心眼小|知微
心神不安|立立亂
心算|口數
心緒|心機
心肝兒|心肝椗
心肝寶貝兒|心肝椗
心肝寶貝|金叵羅
心腸好|好人事
心腸|心地
心血|心機
心血白費|白費心機
心術不正|蠱惑
心裏不安|唔安樂
心裏害怕|怯怯地
心裏明白|心知肚明
心裏癢癢|心郁郁
心裏老惦著|心掛掛
心裏老想著|心思思
心裏舒暢|心甜
心裏舒服|心爽
心裡忍不住|唔抵得
心裡明白|心水清
心裡甜甜的|嗒糖
心計|腦
心跳|扎扎跳
心跳聲|乓乓聲
心野|冇定性
心靜平靜下來|條氣順晒
心頭火起|一把火
心願|心水
心驚肉跳|心驚膽跳
心驚膽戰|心驚膽跳
心驚膽顫|心都離埋
心驚|震
必勝|冇得輸
必定|定必
必死無疑|實死冇生
必然|是必
必然注定|整定
必要|要寫
必須|事必
忌口|戒口
忌嘴|忌食
忌|棹忌
忌諱|棹忌
忍不下氣|唔忿氣
忍不住|唔抵得
忍不住氣|抵頸唔住
忍受不了|受唔得
忍受不住|頂唔順
忍受|抵
忍得住氣|抵得頸
忍氣|下啖氣
忍氣吞聲|下啖氣
忍無可忍|佛都有火
忍着不去做某事|忍手
忍飢挨餓|捱飢抵餓
忐忑不安|十五十六
忒|得滯
志向高|心頭高
忘了|唔記得
忘|唔記得
忘恩負義|反骨
忘記|唔記得
忙不迭|淋擒
忙亂|陀陀擰
忙來忙去|周圍工
忙|唔得閑
忙得喘不過氣來|做到氣咳
忙東忙西|周圍工
忙碌|唔得閒
忙碌地幹|揗
忙碌奔波|揗
忙線|打唔通
忠厚正直|忠直
忠實|冇乜嘢
忠心支持者|忠實擁躉
忤逆|逆意
快快|拿拿臨
快快長大成人|快高長大
快樂|一樂也
快活|高興
快當|快趣
快而馬虎|淋擒
快艇|舢板
快行|飛
快要下雨|翳緊雨
快要|就嚟
快跑|發腳
快速|快脆
快過年了|挨年近晚
快遞|速遞
快點兒|快啲
快點|快啲
念叨|吟
念完經趕和尚|打完齋唔要和尚
念經|喃無
念順口溜|唸口簧
念頭|諗頭
忽冷忽熱|陣冷陣熱
忽然之間|忽然間
忽略|唔理
忽視|睇漏眼
怎可少了|點少得
怎樣也是死|橫又死、掂又死
怎樣兒|點樣
怎樣才好|點樣好
怎樣說都可以|點話點好
怎樣醃製|點醃法
怎麼去|點行
怎麼可以|點可以
怎麼少得了|點少得
怎麼會這樣|有冇搞錯
怎麼會|邊度
怎麼樣|點噉
怎麼能使|點得
怎麼能|點得
怎麼著也|衰衰地
怎麼行|點得
怎麼說也不行|乜都假
怎麼辦才好|點算好
怎麼辦|點算
怎麼|點
怒不可遇|火遮眼
怒斥|問候
怒氣大|火紅火綠
怒氣沖沖|獳爆爆
怒氣衝天|一把火
怒火中燒|火遮眼
怒火沸騰|心滾
怒|獳
怒目圓睜|眼睩睩
怒髮衝冠|火蓋頂
怕冷|寒雞
怕幹活兒|惜手惜腳
怕死|惜身
怕羞|怕醜
怕走|怕行
怕離開|怕行
怕|驚
思想不成熟|唔識諗
思想守舊|古縮
思想守舊的人|古老石山
思想意識|腦筋
思想落後|盟塞
思想閉塞|盟塞
思索妙計|度橋
思索|諗
思考能力|諗頭
思路混亂的人|烏龍王
思路清晰|心水清
怠慢|待慢
急不及待|擒擒青
急不可待|發驚青
急不擇路|事急馬行田
急促地呼吸|唞大氣
急切|喉急
急匆匆|猴擒
急彎|急彎位
急忙|頻蹸
急急忙忙|急急腳
急性瞼腺炎|眼挑針
急性腹病|絞腸痧
急於大便|屎急
急於小便|尿急
急於走|急急腳
急脾氣|炮仗頸
急診室|急症室
急躁|火爆
急轉彎位置|急彎位
急速下滑|暴瀉
急驚風|急驚
性交|交歡
性子慢|漏氣
性急|喉唫
性情古怪|神神化化
性情改變|轉性
性情曠達|大情大性
性情爽直|直腸直肚
性情輕浮|唔夠飣
性情開朗的人|開心果
性格內向|密實
性格急躁|肉緊
性格文靜|定性
性格暴烈|躁
性格柔順|馴品
性格爽快|心爽
性格率直|爽
性格豪放爽朗|疏爽
性格軟弱|軟腍腍
性格開朗|大癲大廢
性格陰陰沉沉|陰氣
性涼|涼氣
性熱|燥熱
性犯罪者|色狼
怨仇|仇口
怨|呻
怨天尤人|喊苦喊屈
怪不得|唔怪得
怪模怪樣|奇離
怪異|奇離
怪相|異相
怪罪|賴
恃強淩弱|大石笮死蟹
恃惡|靠惡
恐嚇|指嚇
恐怕|睇怕
恐怖|牙煙
恢復|返
恨不得|宜得
恨|憎
恩將仇報|反骨
恩愛|煙蔫
恬靜|倓定
恭維|笠高帽
恰巧|竅
恰當|到位
悄悄收藏的東西|地藏
悄悄|靜靜雞
悅|悦
悍匪|大賊
悔恨|恨錯
悜才|曬書櫃
悠游|悠悠閑閑
悠然|悠悠閑閑
悠然自得|他佻
悠閑|他條
悠閒|他條
患肺結核的人|肺癆柴
患難與共|同撈同煲
患麻風病|發風
您早|早晨
您|閣下
悲慘|慘情
悲痛|抌心口
悲苦的樣子|喊噉口
悶死|悶親
悶熱|翳焗
悶|翳
情人交往|行
情人|拖友
情勢|勢色
情報員|線人
情報|線報
情夫|契家佬
情婦|契家婆
情急|媌
情況不好|唔掂
情況|乜頭乜路
情況混亂|倒瀉籮蟹
情節|橋段
情緒低落|冇晒心機
情緒平靜|心水清
情色|咸溼
情面|薄面
惋惜|恨
惟獨|惟獨是
惠顧|幫襯
惡人|海洋大盜
惡作劇|整蠱
惡|利害
惡少|惡爺
惡形惡狀|惡形惡相
惡棍|爛佬
惡毒|狼毒
惡狠狠|惡死
惡聲惡氣|聲大夾惡
惦念|掛望
惦念着|心思思
惦念著|心思思
惦記着|恁住
惱怒|嬲
惱火|火滾
想不到|估唔到
想不開|睇唔開
想主意|度竅
想來想去|諗諗下
想吃|開胃
想太多|諗多着
想好了嗎？|諗掂未呀？
想得開|睇開
想念|掛住
想想辦法|諗下計
想法多|多心
想法|諗頭
想清楚|諗真
想當頭兒的人|一哥
想的想|心思思
想着少花錢|恁縮數
想睡|眼瞓
想睡覺|眼瞓
想著|乃念
想表現自己的能幹|爛嚦
想要你幫忙|想你幫下手
想要|望
想要用的時候|叫起手
想計策|恁計
想|諗
想起來|醒起
想起|醒起
想通|諗掂
想錯了|捉錯用神
想錯|諗錯隔籬
惹一身臊|惹屎上身
惹上很多麻煩|一身蟻
惹了一身麻煩|周身屎
惹了大禍|大鑊
惹事|撩交
惹事生非|撩是鬥非
惹人憎惡|乞人憎
惹人羨慕|恨死隔籬
惹|撩起
惹是生非|惹是惹非
惹眼|醒目
惹笑|搞笑
惹麻煩|成身蟻
愁悶不語貌|愁默默
愁|憂
愁眉苦臉的人|苦瓜乾
愁眉苦臉|苦口苦面
愁雲滿臉|苦瓜乾噉口面
愉快|心爽
愉快歡笑的樣子|好笑口
意向|心肝
意圖|心水
意外好處|飛嚟蜢
意外的事|冬瓜豆腐
意外的情況|冬瓜豆腐
意外|突兀
意外而糟糕的事|景轟
意大利式薄餅|披莎
意大利粉|意粉
意想不到|估佢唔到
意氣相投|冇乜兩句
意見不合|冇傾蓋
愚人|阿丁
愚弄|搵笨
愚笨|戇瞿
愚笨的人|大番薯
愚蠢|死蠢
愚蠢的人|傻佬
愛做什麼做什麼|各適其適
愛出風頭|沙塵
愛刁難|㤿悶
愛吃喝|好飲好食
愛吃鬼|為食貓
愛咋呼|巴喳
愛咋呼的人|大喊十
愛哭|爛喊
愛哭的孩子|爛喊貓
愛嘮叨|吟噆
愛好成癖|爛癮
愛好|癮
愛好者|友
愛怎樣就怎樣|幾大就幾大
愛惜東西|惜嘢
愛惜|矜惜
愛慕|愛
愛打扮|花弗
愛挑剔|㤿憸
愛搗蛋|好貔貅
愛撤嬌的孩子|扭計星
愛斤斤計較|知微麻利
愛欺負人|蝦蝦霸霸
愛死你|惜晒你
愛漂亮|貪靚
愛理不理|闊佬懶理
愛生悶氣的人|鼓氣袋
愛笑的女子|大笑姑婆
愛笑鬧|大癲大廢
愛答不理|唔瞅唔睬
愛管閑事|諸事
愛管閒事|諸事
愛美|貪靚
愛|興
愛說下流話|爛口
愛說俏皮話|口花花
愛說是非的男人|八卦公
愛說粗話|粗口
愛說說道道|好傾好講
愛說閒話|八珍
愛護|菢
愛開玩笑|生鬼
愜意|寫意
感冒|傷風
感到厭惡|飽死
感到害怕|腳軟
感到害羞|羞家
感到為難或討厭|頭刺
感到|覺
感到討厭|眼冤
感暑|焗暑
感覺舒服|自然
感覺|覺
感謝|多謝
愣了一下|愕一愕
愣住了|定晒形
愣|夾粗
慈|慈
態度不好|烏口烏面
態度兇惡|惡形惡相
態度冷酷|鼓氣
態度斯文|倓定
態度生硬|倔
慌失失|失失慌
慌張|驚青
慌慌張張|慌失失
慌慌忙忙|慌失失
慌里慌張|失失慌
慘了|大禍
慘|慘情
慢吞吞的|好𥹉
慢吞吞|靡靡摩摩
慢工出細活兒|慢工出細貨
慢悠悠|滋悠
慢慢兒還債|長命債長命還
慢慢|施施然
慢條斯理|施施然
慢著|咪住
慢走|好行
慢車道|慢綫
慢點|靡啲
慣用|用慣
慣|縱
慪氣|霎氣
慫恿|唆擺
慰解|開解
慶幸|偷笑
慶祝|啤啤佢
慷慨|爽脆
憂慮|心實
憋了一肚子氣的人|鼓氣袋
憋尿|急尿
憋得住氣|抵得頸
憋悶|翳
憋氣|翳氣
憋着尿|尿急
憋著大便|屎急
憋著氣用力|鼓住道氣
憎恨|憎
憑空而來|飛
憑證廢止清冊|證書撤銷清單
憑證管理中心|核證機關
憑證|證書
憔悴|累瘁
憤怒|嬲
憤怒的樣子|睜眉突眼
憤憤不平|條氣唔順
懂事|生性
懂人情世故|入世
懂得不多|半桶水
懂得吃喝|識飲識食
懂得吃|會飲會食
懂得多|師傅
懂得怎麼辦|識做
懂得美食之道|識飲識食
懂得羞恥|知醜
懂得|識得
應付|拆招
應允|應承
應徵面試|出嚟見工
應時的蔬菜|時菜
應答|聽電話
應聲回答|應
應許|答允
應該|該
應諾|應承
應變|執生
應酬|充撐
懵懂|懵閉閉
懵懵懂懂|懵盛盛
懶人|四方木
懶得管|懶理
懶得|費事
懶得過問|闊佬懶理
懶惰|懶
懶惰的人|懶蛇
懶洋洋|唔嗲唔吊
懶漢|四方竹
懶漢鞋|懶佬鞋
懶理|一於少理
懶|蛇王
懶蟲|死懶鬼
懶驢多上磨屎尿多|懶人多屎尿
懶骨頭|蛇王
懶鬼|死懶鬼
懷|佗
懷孕|馱胎
懷有孩子|馱住個仔
懷疑|思疑
懷著|陀
懷錶|袋錶
懸得乎|危危乎
懸掛在空中晃蕩|吊吊揈
懸掛|椗
懸|牙煙
懸賞殺人|買起
懸雍垂|喉嚨椗
戀人|拖友
戀家|黐家
戀愛關係破裂|甩拖
戇厚|戇直
成一排坐好|排排坐
成事|埋欄
成全|成
成分|成份
成功大學|成功大學
成功少碰壁多|撞板多過食飯
成功|得着
成名作|手本戲
成天價|成日
成對|打孖
成|得
成本|皮費
成本高|為皮
成熟|黃
成群結隊|聯群結隊
成膠狀|起膠
成雙|打雙
我們|我哋
我先生|我老公
我太太|我老婆
我妻子|我老婆
我沒有份|沒有我份
我班的同學|我班同學
我的最愛|收藏
我的電腦|部腦
我跟你|我孖你
戒備森嚴|睇到拫
或多或少|唔多唔少
或是|定係
或者|定抑
或許|一係
戥子|釐戥
截兒|橛
截|橛
截止期限|死綫
截長補短|拉上補下
戲|劇
戲劇|劇
戲劇演員|戲仔
戲劇的精彩部分|戲肉
戲劇高潮|戲肉
戲子|紅船中人
戲弄|揾笨
戲情說明書|戲橋
戲指拳頭|錘頭
戲曲演員|大佬倌
戲曲演員的唱功|喉底
戲本|手本
戲水|玩水
戲法|術
戲的高潮|戲肉
戲票|戲飛
戲稱愛哭的孩子|喊包
戲裝|戲服
戲院|院線
戳|㧻
戳穿|篤爆
戴孝|着孝
戴眼鏡的人|四眼佬
戴眼鏡的女孩兒|四眼妹
戴綠帽|做龜公
戴高帽|笠高帽
戶|伙
戾狗邊|犬字邊
房內的隔離板牆|板障
房地產證|樓契
房地産套牢|樓蟹
房契|屋契
房子|屋
房東|屋主
房梁|枋
房樑|屋樑
房產交易|樓市
房頂兒|瓦背頂
房頂|瓦面
所以|搞到
所有人|冚不論
所有人都知道|係人都知
所有|各樣
所有時間|分分鐘
所有的人|冚不論
所有的|冚
所選的|揀中嘅
所|間
扁擔|擔潤
扁沙鍋|瓦鐺
扁豆|龍牙豆
扇子|扇
扇車|風櫃
手下|馬仔
手中無東西|空手掉空臂
手中無物|吉手
手僵|手硬
手到擒來|當食生菜
手勁兒|手力
手動|人手
手動換檔裝置|棍波
手套兒|手襪
手套|手襪
手好動|手痕
手工太次|單薄
手工技藝|手作
手巧|手乖
手帕|手巾仔
手心兒|手板心
手心|手板心
手心朝上、手背朝下|攤大手板
手忙腳亂|揗雞
手感好|爽手
手感很爽|爽手
手指甲|手甲
手指縫兒|手指罅
手指縫太寬|手指罅疏
手指頭|手指
手掌|手板
手排|棍波
手推車|手車
手提包|手袋
手提無線電話|大哥大
手提籃|手抽
手提袋|手搊
手提電話|大哥大
手杖|士的
手榴彈|菠蘿彈
手槍|短火
手機|手提電話
手段低劣|低張
手段|招數
手段高明|高張
手氣|手神
手癢癢|手痕
手發酸無力|手軟
手絹兒|手巾仔
手絹|手巾仔
手緊|水緊
手肘|手㬹
手腕子|手骹
手腳不乾淨|手腳唔好
手腳並用地爬|四腳爬爬
手腳乾淨|好手腳
手腳亂顫|手揗腳震
手腳僵硬|𣤩手𣤩腳
手腳發抖|手忳腳震
手腳都摔破了|損手爛腳
手腳都有傷|損手爛腳
手臂|手肱
手臂搖擺|擺手擺臂
手藝人|手作仔
手藝|手作
手藝高|妙品
手足無措|揗雞
手足癬|香港腳
手銬|手扣
手錶|腕表
手鐲|手鈪
手電筒|電筒
手頭大方|疏爽
手頭緊|水緊
手飾|手箍
手鬆|手疏
才|先
才到|至到
才剛|頭先
才好"|至好
才好|至好
才對|至啱
才怪|至奇
才成|至得
才會|先至
才有|先得
才知道|至知
才能|先至
才能夠|先至
才能"|才能
才行|至得
扎了|插中
扎|戛
扎猛子|插水
扑克王|細鬼
扑克的王|鬼
扒手|荷包仔
扒拉|快炒
扒竊|打荷包
扒開|啡
打不了主意|咬唔入
打交道|交易
打住|閘住
打保票|打包單
打個轉兒就回來|打白鴿轉
打個轉|打白鴿轉
打倒|㧬低
打倒在地|做低
打傘|擔遮
打光棍兒|單身寡仔
打入|櫼
打冷嗝兒|打思肊
打冷顫兒|打冷震
打冷顫|打冷震
打前失|失蹄
打劫|騎劫
打勾兒|打剔
打勾|剔
打叉兒|打交叉
打叉|打交叉
打呵欠|打喊路
打呼嚕|打鼻鼾
打呼|打鼻鼾
打哆嗦|忳忳震
打哈哈|講笑
打哈欠|打喊路
打哈赤|打喊路
打嗝兒|打噎
打嗝|打嘶噎
打噎|打思噎
打噴嚏|打乞嗤
打地基|打樁
打垮|抨沉
打埋伏|伏
打太極拳|耍太極
打太極|耍太極
打好基礎|鋪路
打好的棉花胎|棉胎
打存摺|打簿
打寒顫|打冷震
打小報告|篤背脊
打小抄|出貓
打小算盤|諗縮數
打屁股|打屎胐
打岔|岔亂
打工|打工仔
打得落花流水|打到落花流水
打悠千|打千秋
打情罵俏|放生電
打成一片|打得埋
打手|打仔
打手掌心|打手板
打扮得像|打扮成
打扮得光鮮|身光頸靚
打扮得很漂亮|執到正
打扮漂亮|輯正
打扮|裝身
打拳|耍功夫
打掃一下|掃下
打掉|拼
打擺子|發冷
打擾一餐|黐餐
打擾了|騷擾晒
打擾|嘈我
打敗|打沉
打斷別人|岔亂歌柄
打斷|打躓
打斷話頭|插亂戈柄
打更|看更
打杠子|打杠
打杠|戙大杉
打架|打交
打格子|間格
打桌球|督波
打槍|燒槍
打死|做低
打|毆
打毛衣的針|織針
打氣|泵氣
打氣筒|氣泵
打淨撈乾|汁都撈埋
打滑|跣胎
打滾兒|捵
打火機|火機
打烊|閂鋪
打燕|踢燕
打牌|竹戰
打牙祭|做禡
打球|打波
打盹兒|烏眉瞌睡
打盹|瞌埋雙眼
打着燈籠找你|打鑼咁搵你
打瞌睡|瞌眼瞓
打瞌睡貌|烏眉瞌睡
打破沙鍋問到底|打爛沙盤問到篤
打破砂鍋|打爛砂盆
打碎|打爛
打秋千|打千秋
打空翻|打關斗
打穿砂盆問到底|打爛沙盤問到篤
打算|諗住
打結兒|打綟
打結|打綟
打群架|開片
打翻|倒瀉
打聽價格|格價
打腫臉充胖子|充大頭鬼
打著|打住
打蒼蠅。|拍烏蠅
打蟲子|毒蟲
打蟲|毒蟲
打褶子|打褶
打賭|輸
打赤膊|打赤肋
打退堂鼓|縮沙
打通關係|打色
打邊鼓|打鼓邊
打醮時搭的棚子|醮棚
打錯電話|搭錯線
打鐵趁熱|打鼓趁興
打閃|閃電
打開|拗開
打開門戶|開門
打開"|開到
打雜|散仔
打雷|行雷
打電話打了很久|煲電話粥
打頭陣|頂頭陣
打顫兒|打震
打顫|打震
打麻將|竹戰
打麻雀|攻打四方城
打鼓兒|收買佬
打鼾|撦鼻鼾
扔|掟
托兒|薦
托巴哥|多巴哥
托排球|搓排球
托福|托賴
托褔|托賴
托起|兜
扛|佗
扛大旗|擔大旗
扣了|扣住了
扣子|衫鈕
扣板機|摱雞
扣球|扻波
扣眼兒|紐門
扣眼|紐門
扣緊|相食
扣起了|扣住了
扣除|減除
扭傷了腰|扭親條腰
扭傷了腳|屈到腳
扭傷|屈親
扭傷腳踝|拗柴
扭在一起|絞
扭怩|扭擰
扭扭捏捏|扭擰
扭捏|扭擰
扭曲不平|殽
扭曲變形|攣弓蝦米
扭轉|擰轉
扭轉臉|擰乜面
扭頭|擰轉頭
扮傻|詐傻扮懵
扮成|扮到
扮演|扮
扯平均|拉勻
扯皮|講古
扯貓尾|絣貓尾
扳回|摱返
扳子|士巴拿
扳手|士巴拿
扳手腕|拗手瓜
扳|拗
扳着臉|黑口黑面
扶不上牆|爛泥扶唔上壁
扶得東來西又倒|顧得頭嚟腳反筋
扶正|坐正
扶起來|扶正
批八字|起八字
批改作業|改簿
批改|批
批評|彈
找不到|冇影
找不找得回來|揾唔揾得返
找人|搵腳
找來|揾埋
找便宜|搵着數
找倒霉|博拉
找借口|借意
找吃|搵食
找各種關係|蜎窿蜎罅
找回的錢|找贖
找回|續返
找回錢|找數
找娛樂|搵娛樂
找小老婆|包二奶
找岔子|搊後腳
找工作|搵工
找情夫|搵佬
找|揾
找搭檔|搵腳
找架打|撩交打
找死|作死
找活路|搵米路
找消遣|搵娛樂
找生活|搵世界
找生計|搵食
找碴兒罵街|鬧神鬧鬼
找碴|搊掅
找竅門兒|度橋
找老伴|煲老藕
找老婆|搵老婆
找路子掙錢|搵米路
找醫生|睇醫生
找野男人|勾佬
找錢|找數
找關係|搵路
找零頭兒|找贖
找飯碗|搵食
找麻煩|找晦氣
承受力夠|受力
承情|盛惠
承擔|擔帶
承當|服
承蒙您的好話|承你貴言
承蒙照顧|盛惠
承認|擔認
承諾|應承
技癢|手痕
技能|散手
技藝|散手
技術規程|架步
抄下|抄低
抄作業|抄功課
抄家伙|拉家伙
抄寫|抄書
抄襲功課|抄功課
把事情搞壞|倒米
把人看得很差|睇衰
把他臭罵一頓|鬧衰佢
把住小孩|勒
把兄弟|砂煲兄弟
把別人的話|學口學舌
把|將
把心一狠|把心一橫
把手|耳
把招牌拆掉|拆招牌
把握|揸拿
把柄|痛腳
把楔子打入|櫼
把氣憋在心裏|翳氣
把熱的食物涼|攤
把脈|揞脈
把衣服全脫光|剝光豬
把釘拔起來|起釘
把錢拿出來|回水
把錢收下|代代平安
把錢看得最重|睇錢緊
把風|睇水
抑制|制
抑或|定係
抑鬱|閉翳
抓下來|揾落
抓人|拉人
抓住弱點|搊痛腳
抓住|搲住
抓你把柄|搊你後腳
抓傷|搲損
抓到|拉上
抓取|執
抓回|執返
抓|揸
抓準|吼準
抓牢|揸實
抓緊|睺住
抓葯|執茶
抓藥|執茶
抓起來打|摷佢一身
抓辮子|搊後腳
抓鬮兒|執籌
抓鬮|執籌
投入|肉緊
投合|埋欄
投放|落
投標|認投
投機倒把|炒買炒賣
投機倒把者|黃牛黨
投機|偷雞
投籃|恤波
投藍|射籃
投資|斥資
投身|𡚒身
抖動|扽
抖|抰
抖摟|抰
抖擻精神|打醒精神
抖起來|撈起
抖開|唞
抗議行動|工業行動
抗議|鬼殺噉聲
折了大本錢|瓜直
折合|申
折成|拗開
折扣|折頭
折斷|拗斷
折本|虧負
折水|縮水
折疊傘|縮骨遮
折磨|糟騭
折騰|炮製
折骨傘|縮骨遮
披上|摟上
披肝瀝膽|有肝膽
抬儀仗的人|親家郎
抬杠|頂頸
抬杠鬥氣|詏氣
抬槓|拗頸
抬起來|搊
抬起頭|覘高頭
抬轎子|托大腳
抬頭|昂頭
抬高價錢|吊高嚟賣
抬高|昂高
抱佛腳|死冞
抱屈|唔抵
抱怨|怨唱
抱|攬
抱歉|唔好意思
抱窩|哺竇
抵不住|忍不住
抵押|按揭
抵擋|格
抵擋災難|擋災
抹子|灰匙
抹布|抹檯布
抹平|抿返
抹泥刀|灰匙
抹灰|批蕩
抹石灰漿|灑灰水
抹胸|胸圍
抹黑|老屈
抻|繃
抻腿|雙腳撐直
抻麵|拉麵
押送|押
押送犯人|解犯
押金|按金
抽佣|抽水
抽取佣金|抽水
抽取|撏
抽屜|櫃筒
抽打|藤條炆豬肉
抽掉|撦晒
抽水|泵
抽水馬桶|水廁
抽煙|食煙
抽簽|執籌
抽籤|撍籌
抽苔|起心
抽菸|食煙
抽薹|起心
抽風機|抽氣扇
抽|食
抿|渳
抿着嘴笑|微微嘴笑
拂塵|塵拂
拆信刀|信肉
拆台|擘面
拆掉|拼
拆毀|拆
拆簽|解簽
拆臺|倒米
拇指|手指公
拈鬮法|畫鬼腳
拉低|扯低
拉使升起|扯
拉倒|霸就
拉呱|傾計
拉屎|屙扽
拉平|拉勻
拉得緊|繃繃繄
拉扯|褫
拉拉雜雜|乜乜物物
拉拔|湊
拉洋片|西洋鏡
拉皮條|撦皮條
拉秧|絣藤
拉稀屎|屙渜
拉稀|肚屙
拉窗|摥窗
拉箱|落箱
拉綫|扯綫
拉緊|拫
拉線木偶人|扯綫公仔
拉縴|拉纜
拉肚子|肚痾
拉肚|屙肚
拉腸|布拉腸粉
拉著|撦住
拉近|拉埋
拉鍊|褲鍊
拉門|摥門
拉隊伍|班
拉風箱|扯風箱
拋棄|飛起
拋錨|死火
拌一拌|攪一攪
拌和|攎
拌嘴|駁嘴
拌|撈
拌麵|攎麵
拍手叫好|拍爛手掌
拍打|拍
拍拖|拍
拍攝|攝錄
拍照|影相
拍照聲|輯
拍肩膀|搭膊
拍胸脯|拍心口
拍賣|出血
拍賣的貨物|夜冷貨
拍電影|拍片
拍馬屁|擦鞋
拐子|拐子佬
拐彎兒|掟彎
拐杖|拐
拐棍兒|士的
拐棍|士的
拐角處|轉角
拐賣人口者|拐子佬
拐|趷
拒絕你|托你手㬹
拒絕演出|劈炮唔撈
拒絕|耍手擰頭
拒絕載客|拒載
拔出|撏
拔尖兒|標青
拔掉|掹走
拔河|撦大纜
拔牙|脫牙
拔|絣
拔腿|發腳
拔頭籌|飲頭啖湯
拖兒帶女|拖男帶女
拖地|地拖
拖帶|褦
拖把|地拖
拖|拉
拖拉懶散|懶慢
拖拖拉拉|𥹉糯
拖掛車廂|後卡
拖掛車|拖卡
拖斗卡|拖卡
拖時間|耽時候
拖泥帶水|𥹉糯
拖累|佗衰
拖累別人|累人累物
拗口|詏口
拘捕|拉上
拘束|思縮
拘留所|差房
拘留控告|拘控
拘票|花令紙
拘謹|思縮
拚命|搏命
拚搏到底|搏到盡
招人恨|乞人憎
招來麻煩|惹屎上身
招兒|符弗
招呼|嗌
招引|勾
招待員|侍仔
招惹仇恨|招人仇口
招惹|揄
招惹是非|惹是惹非
招手|揖
招|挹
招搖撞騙|呃呃騙騙
招攬|兜搭
招數|八寶
招財貓|櫃位貓
招贅|招郎入舍
招風耳|兜風耳
招風耳朵|兜風耳
拜下風|低威
拜太公|拜祠堂
拜懺|打齋
拜托|托賴
拜把子|拜案
拜掃|拜山
拜託|好心
拜訪|探
拜認|契
拱兵|督卒
拱卒|督卒
拱狀門或屋頂|閬
拱起|局
拳|捶
拳擊運動|打卜成
拳術|功夫仔
拳頭|錘
拴牛的木橛子|牛樴
拷紗|香雲紗
拷貝|複製
拼合|嵌
拼命吃|狂食
拼命地干活|擂
拼命地說話|口水花噴噴
拼命幹活兒|捱生捱死
拼命幹活|搏命
拼命抓|死挖爛挖
拼命拿|死挖爛挖
拼命|死咁
拼命節省|死慳死抵
拼命纏住不放|死纏爛打
拼圖|砌圖
拼寫|串
拼搏|搏
拼死拼活|替生替死
拼法|串法
拼湊|湊夠
拼砌|砌
拼老命|搏老命
拾人唾涕|執人口水溦
拾人涕唾|執人口水溦
拾人牙慧|執人口水溦
拾人餘唾|跟人口水溦
拾到|執到
拾掇|執拾
拾荒者|收買佬
拾起來|執起
拾起|執起
拿不定主意|心大心細
拿不準主意|心大心細
拿主意|打色
拿了牌照|有牌
拿他沒辦法|咬唔入
拿個|拎個
拿出|推出
拿去|拎去
拿回扣|扣佣
拿回|拎返
拿定|揸定
拿得起|拎得起
拿手好戲|手本戲
拿|攎
拿着燒餅當枕頭|捉到鹿唔識脫角
拿著|拎住
拿藥|執藥
拿號兒|輪籌
拿起來|拎起
拿起|拎起
拿起筷子|起筷
拿錢來|傍水
拿錢出來|度水
拿錢|攞錢
拿錢買罪受|貼錢買難受
持久的力氣|長蓬力
持|拎
持械行劫|械劫
持續時間|有幾耐
持續高位|高企
挂斷|收線
指印|手指模
指手划腳|指手督腳
指手畫腳|指手擉腳
指揮|擔大旗
指|擉
指望天氣|望天打卦
指望|指倚
指桑罵槐|譠打
指模|手指模
指派|交待
指甲刀|指甲鉗
指甲|手甲
指甲油|指甲水
指甲縫|手甲冥
指甲草|燈盞花
指甲蓋兒|手指甲
指示|點
指紋印|手指模
指紋|手指模
指縫|指罅
指著發議論|指指彈彈
指責|彈
指隙|手指罅
指雞罵狗|單單打打
指點迷津|盲公竹
按下按鈕|撳掣
按下|撳低
按停|煞停
按制度|執正
按原則|執正
按喇叭|響按聲
按常例叫菜|例牌
按摩|指壓
按|撳
按時|依時依候
按本分應該|應本分
按次序等待|輪
按照|按照
按照樣子|照樣
按脈|把脈
按規矩|執正
按說|照計
按道理|計正
按鈕|掣
按鍵|掣
挎|挽
挑不出毛病|冇得彈
挑來揀去|左揀右揀
挑兒|擔
挑剔|彈
挑剩|揀剩尾
挑去|辟
挑吃挑喝|揀飲擇食
挑吃|揀飲擇食
挑唆|唆擺
挑大梁|擔綱
挑大樑|擔大旗
挑揀|擇
挑撥|唆擺
挑撥是非|撩事鬥非
挑撥離間|攪三攪四
挑毛病|搊掅
挑眼|搊掅
挑逗|撩下
挑選|剔
挑選吉日|擇日
挑選者|揀手
挑食|擇食
挖人瘡疤|捉人痛腳
挖坑|開坑
挖扣眼兒|開鈕門
挖|掘
挖槽|起柳
挖洞|掘洞
挖牆角|撬牆腳
挖耳垢|取耳
挖苦|諦
挨凍|抵冷
挨家挨戶|挨家過主
挨日子|挨世界
挨罵|醜人
挨近|哄
挨門挨戶|挨家過主
挨餓|扎炮
振作起來|扚起心肝
振動|扽
挺刮|直板
挺可愛|幾可愛
挺好|幾好
挺屍|攤屍
挺得住|頂得順
挺括|硬身
挺|撐
挺直了|死直
挺神氣|夠威
挺胸凸肚貌|躽身躽勢
挺胸凸肚|躽胸突肚
挺脫|硬身
挺腹|躽
挺身|𡚒身
挽|拖
挽著|繑住
挽起|捋起
挽面|掹面毛
捂|揞
捂汗|焗汗
捂腳|焗腳
捅了大|大鑊
捅了大婁子|大鑊
捅婁子|倒米
捅漏子|倒米
捅類子的人|倒米壽星
捆|扎
捉奸|捉雞腳
捉弄你|整鬼你
捉弄|舞
捉拿到|拉上
捉|搊
捉襟見肘|顧得優鞋又甩髻
捉迷藏|捉伊人
捋扣|滑牙
捋|擸
捋起褲管|摺高褲腳
捎個口信|搭句說話
捎口信|寄聲
捎帶|搭單
捎色兒|甩色
捎話|搭句說話
捏|摙
捐助|捐去
捐給|捐去
捐贈|捐去
捐錢捐多些|淰啲筆
捐錢辦善事的人|善長仁翁
捕捉|拉
捕鳥|裝雀
捧他|畀高帽佢戴
捧場|抬轎
捧場的人|擁躉
捧場者|擁墩
捧|掂
捧著|兜住
捨不得|唔捨得
捯氣|扯氣
捱千刀|斬犯
捱|抵
捱日子|耽日子
捱餓|捱飢抵餓
捲尺|拉尺
捲|攞
捲曲|攣
捲毛|攣毛
捲起|捋起
捲起褲管|摺高褲腳
捲起褲腿兒|摺高褲腳
捲高|捋高
捶打|搨
捶打自己的胸部|捶心抌肺
捶|搨
捶擊|抌
捶背|抌骨
捶胸口|抌心口
捶胸頓足|抌心抌肺
捻|摙
掀|搴
掂念|掛住
掂記|掛住
掃墓|拜山
掃射|狂掃
掃尾|輯手尾
掃帚|掃
掃帚星|掃把星
掃|擸
掃興|冇癮
掃蕩|冚竇
掃視|擸
掄拳|揈
掄|揈
授權|牌照
掉下山去|跌咗落山
掉下巴|甩下爬
掉了|唔見
掉包兒|頂包
掉在地上也沒人要|執到都喊三聲
掉底兒|甩底
掉書袋|丟書包
掉牙|甩牙
掉色兒|甩色
掉色|甩色
掉褲子|甩褲
掉進水中|跌咗落水
掉頭|掉轉頭
掉髮|甩髮
掌兒|鞋碼
掌勺|候鑊
掌勺兒|伙頭
掌勺子|候鑊
掌握|上手
掌櫃|事頭
掌櫃的老婆|事頭婆
掌權|打骰
掌灶兒|伙頭
掌管|揸手
掌聲如雷|拍爛手掌
掏兜兒|打荷包
掏別人的錢包|割荷包
掏|揞
掏空口袋|撢穿袋
掏糞|倒屎
掏腰包|挖荷包
掏薄|偷
掏錢包|撢荷屯
掐了癮頭|吊癮
掐架|打交
掐頭去尾|斬頭截尾
排便|出恭
排列好|排法
排列|排法
排到|輪候到
排叉兒|蛋散
排在前頭|排頭位
排場大|大陣仗
排場|體面
排大隊|排長籠
排字|植字
排尿|屙尿
排泄|屙
排第一|排頭位
排號兒|輪籌
排行最大|長
排長隊|排長龍
排除|飛起
排隊|排長龍
排隊掛號兒|輪籌
排隊的隊伍|人龍
排隊等候|輪候
排隊買票|輪飛
排骨|排
掖扶|插
掙一頓吃一頓|餐搵餐食
掙扎|跈
掙錢|搵銀
掙錢的門路|米路
掙錢糊口|搵食
掙飯吃|搵食
掛了|扣住了
掛心|掛意
掛念|掛住
掛慮|霎氣
掛掉|摜低
掛斷|收綫
掛斷電話|收線
掛燈|開燈
掛號信|擔保信
掛錶|砣錶
掛電話|收線
採購員|買手
採購|買手
探問行情|格價
探望|探
探監|拜山
探親|探家
探訪|探
探頭探腦|思思縮縮
接上關係|搭綫
接上|駁
接下來|跟住落嚟
接下茬|搭嘴
接不上嘴|甩嘴
接不住|甩腳
接受不了|唔受得
接受|受落
接受教育|聽教
接合|佮
接吻|啜嘴
接地綫|拖綫
接待人員|知客
接手工作|揸二攤
接洽|斟
接|湊
接班人|二手
接生|執仔
接生婆|執媽
接納|受落
接綫板|拖板
接聽電話|聽電話
接著上|食住上
接著|跟住
接見客人|見客
接觸到地上|拖地
接載|載
接近年底|挨年近晚
接近歲晚|挨年近晚
接近|臨到
接近除夕的日子|年晚
接錯綫|搭錯綫
接電話|聽電話
接頭兒|接頭
接駁口|接頭
接駁車|穿梭巴
接駁|駁
推三推四|支支坐坐
推介|心水
推倒|㧬跌
推出|出爐
推出市場|出街
推剪|鏟
推卸|卸膊
推卸責任|卸髆
推回|摥返
推土機|剷泥車
推委|推搪
推子|推剪
推廣介紹|推介
推延|押後
推托|托手㬹
推|擁
推擊|搋
推擠|逼
推薦|推介
推讓|支窒
推頭|剃頭
掩|搕
掩蓋|埋
掬|兜
掮客|水客
掰了|擘網巾
掰腕子|拗手瓜
揀|剔
揉|搋
揉搓|捼下
揍|搨
描|印
描字帖|印字格
描紅模子|描紅
描色|上色
描述|斟
提上|扚上
提供令人震驚的消息|爆大鑊
提供令人震驚的資料|爆大鑊
提供|供畀
提供消息|爆料
提供資料|報料
提價|起價
提出來|起
提出問題|發問問題
提包|手袋
提味|吊味
提土旁兒|土字邊
提土旁|剔土邊
提子|葡提子
提審|提堂
提手|挽手
提手旁兒|剔手邊
提手旁|剔手邊
提拔|帶挈
提攜|帶挈
提早|預早
提梁|挽手
提溜|掅
提着|挽
提示卡|貓紙
提示性信息|貼士
提示|貼士
提神|醒神
提綫木偶|扯綫公仔
提著|搊住
提訊|提堂
提詞兒|提水
提詞|提水
提貨單|出水紙
提起十二分精神|打醒十二個精神
提起|搦起
提起精神|打醒精神
提醒|提點
提防|顧命
提鞋|挽鞋
提高一點兒|定高一點
提高注意力|打醒精神
提高|調高
提高警惕|打醒精神
提高驚覺|打醒十二分精神
插兜|插手袋
插到底攪拌|挭
插口|插蘇
插嘴|搭嘴
插座|插蘇
插手兜|插手袋
插|攝
插秧時唱的歌|秧歌
插袋|插手袋
插進|𤗈入
插銷|插蘇
插隊|打櫼
插頭|插蘇
揚眉瞪眼|睜眉突眼
揚聲器|大聲公
換乘|轉
換了|換作
換位子|調位
換位置|調位
換位|調位
換作|換轉
換堂|轉堂
換檔杆|波棍
換線|轉線
換肩|換膊
換車|轉車
換過來說|倒轉嚟說
換餅卡|餅咭
握手|扼手
握緊|揸實
握起|搦起
揣度|度
揣摸錯了|捉錯用神
揩拭|抆
揩油|打斧頭
揩油水|打斧頭
揪住|摵
揪心|肉緊
揭出|爆
揭底|爆大鑊
揭|搣
揭曉|揭盅
揭痛處|捉痛腳
揭發|踢爆
揭短|捉痛腳
揭穿內幕|穿煲
揭䁱|開估
揭開|拆穿
揭開謎底|開估
揭露內幕|穿煲
揭露|拆穿
揮動|掝
揮|揈
揮金如土|大使
揮霍|亂揈
揮霍無度|大使
揰打身體|鬆骨
搌布|抹檯布
損人利己|知微麻利
損傷|損
損|唱衰
損失厲害|斬到一頸血
損失慘重|蝕得慘
損害|糟騭
損耗|除拆
搓|捽
搓板兒|洗衫板
搓板|洗衫板
搓洗|幯
搓麻將|打麻雀
搔|𢯎
搖|𢳆
搖來搖去|搖搖岋岋
搖動|掉
搖尾巴|擺尾
搖搖晃晃|岋下岋下
搖搖欲墜|岋岋愩
搖擺|翕
搖擺舞|扭腰舞
搖攤|番攤
搖晃腳|印印腳
搖晃|蕩
搖桿|手掣
搖著頭|頭擰擰
搖頭|擰頭
搖頭晃腦|擰頭擰髻
搗亂|搞事
搗亂者|攪鬼
搗制混凝土|搗石屎
搗物|舂
搗碎|擂爛
搗|舂
搗蛋|貔貅
搗蛋鬼|反斗星
搗鬼|作怪
搜刮|刮
搜尋|揾
搜尋"|揾嘢
搜|抄
搜查|抄
搜羅|擸
搜遍|抄勻
搜集材料|撲料
搞不清|搞不明
搞不清楚|搞不懂
搞事|攪屎棍
搞事者|攪屎棍
搞來搞去|搞搞震
搞垮|踩低
搞壞|劃涴
搞女人|攪三攪四
搞小動作|整蠱弄怪
搞小圈子|埋堆
搞成這樣|搞成咁
搞|搞作
搞砸|累事
搞錯|詐糊
搞鬼|玩嘢
搞點新意|搞搞新意思
搧風耳朵|兜風耳
搪瓷碗|鐵甌
搪瓷釉|青
搬到|搬去
搬動|擔
搬家|搬屋
搬弄口舌|吱喳
搬弄是非|攪是攪非
搬弄是非者|是非竇
搬救兵|班馬
搬是非|搬是搬非
搬起石頭砸自己腳|搬石頭打自己隻腳
搬運工人|咕喱
搬運|運
搭上|搭通
搭上肩|搭上身
搭伙|搭食
搭便車|摱車邊
搭建棚架|搭棚
搭建烤爐|搭爐
搭救|打救
搭橋|扯綫
搭檔|拍檔
搭砌|砌
搭線|拉綫
搭著肩頭|搭膊頭
搭設腳手架|搭棚
搭配合適|合襯
搭配著吃|送
搭配|配搭
搭關係|搭路
搭頭|搭頭搭尾
搭飯餐|搭食
搶位子|爭位企
搶先|偷步
搶到別人前頭|扒頭
搶劫|騎劫
搶座位|爭位坐
搶得一乾二淨|剝光豬
搶著吃|爭食
搶購|掃貨
搶購門票|撲飛
搶走男/女朋友|撬牆腳
搶跑|偷步
搶鏡頭|搶鏡
搶風頭|搏出位
搶麥克風|搶咪
摁扣兒|迫紐
摁|按
摒除|踢出局
摔倒|摜低
摔打|撻
摔|撻
摔跟頭|打關斗
摘下|拋低
摘要|撮要
摘|除
摟住|攬著
摟抱|攬
摟摟抱抱|攬身攬勢
摟摟抱抱的樣子|攬身攬勢
摟|攬
摟着腰身|攬身攬勢
摟肩搭背|攬頭攬頸
摧殘|糟騭
摩|幯
摩托三輪車|雞
摩托|摩打
摩托車手|鐵騎士
摩托車|電單車
摩擦|詏撟
摳字眼兒|捉字虱
摳字眼|捉字虱
摳搜|小器
摳門兒|孤寒
摸不著腦|冇厘頭
摸不著頭腦|一頭霧水
摸底兒|探盤
摸底|探盤
摸|玷手
摸魚|偷雞
摸黃|黃牌
摺疊傘|縮骨遮
撂挑子|卸髆
撇嘴|扁嘴
撇着嘴|扁嘴
撇|藐
撇開|賣甩
撈|兜
撈剩的油水|水尾
撈錢|掠水
撐得慌|飽上心頭
撐|登
撐篙竹|篙竹
撑傘|擔遮
撒丫子|較腳
撒嬌|詐嗲
撒尿|交水費
撒慌|講大話
撒|糝
撒網|拋網
撒謊|講大話
撒野|發茅
撕扯|褫
撕|搣
撕破|擘爛
撕破臉|搲爛塊面
撕破面子|擘面
撕開|搣碎
撞到|扻親
撞大運|博彩
撞擊|碰
撞死|車死
撞球|桌球
撞見|遇
撞運氣|博彩
撞鎖了|摸門釘
撞開|𢼌開
撞騙|白撞
撞騙者|白撞
撣子|掃
撣|揈
撣走|扽走
撤手不管|冇眼睇
撤潑|發爛苲
撥取|撩
撥弄是非|嫽是逗非
撥打|打緊
撥掉|辟
撥接|撥號
撥攏|擸
撥水器|水撥
撥準|校
撥開烏雲見青天|守得雲開見月明
撥雲見天|守得雲開見月明
撥雲見日|守得雲開見月明
撩撥|惏
撩|潲
撫摸|擸
撬杠|鐵筆
播出|出街
播歌|打碟
撮合|揸大葵扇
撲了個空|摸門釘
撲克|啤牌
撲克牌|啤牌
撲滅|撲熄
撲滿|錢罌
撲通|𣿅
撿了|執起
撿人家破爛|執二攤
撿來|執倒
撿便宜|起尾注
撿到|執到
撿回命子|執番條命
撿垃圾|垃圾佬
撿拾遺漏的稻穗|執禾
撿現成兒|執死雞
撿現成|執死雞
撿破爛|執地
撿起來|執返
撿骨|骨殖
擀|研
擁抱着親吻|擁吻
擁擠|擠擁
擁護者|擁躉
擅長|叻
擅闖|白撞
擊中要害|拳拳到肉
擊倒|打到
擊|擂
擊碎|打爛
擊頭黨|扑頭黨
擋住|閂出
擋出|閂出
擋泥板|鏈冚
擋道|阻滯
擋風外衣|風褸
操心|霎氣
操練|操
操縱|擺布
擔任主力|擔綱
擔任|擔當
擔保|打包單
擔子|擔
擔心|慌
擔|擔挑
擔當主要角色|擔綱
擔竿|擔挑
擔負責任|跟
擘藍|芥蘭頭
據說|聽講
擠出|瀄
擠壓|瀄
擠壓腳|夾腳
擠得緊緊|密窒窒
擠牙膏|𢷿牙膏
擠牛奶|揸牛奶
擠眉弄眼|蹔眉蹔眼
擠破|擠爆
擠粉刺|𢷿暗瘡
擠|逼
擠靠著別人|挨身挨勢
擡起頭|𩓥高頭
擤鼻挺|擤鼻涕
擦地板|抹地
擦地用具|地拖
擦大便|抆屎
擦屁股|抆屎
擦|抹
擦拭得|㩢到
擦拭|抹
擦桌布|抹檯布
擦絲|刨
擦絲器|蘿蔔刨
擦黑兒|俟晚
擰不緊|滑牙
擰|搣
擰耳朵|扭耳仔
擱|擠
擱淺|炕沙
擱置|躋
擲錢|摜仙
擴展|放
擴音器|大聲公
擺出陣勢|擺明車馬
擺出|鬧
擺動|掉
擺姿勢|擺甫士
擺家家|煮飯仔
擺布|擺布
擺手|耍手
擺排場|敦款
擺攤兒售賣|擺賣
擺攤兒|擺檔
擺攤子|擺檔
擺架子|擺款
擺樣子|擺款
擺款兒|敦款
擺款|詐型
擺派頭|擺款
擺脫家務|抽身抽勢
擺設|擺
擺譜兒|敦款
擺譜|擺款
擺酒宴恢復關係|擺和頭酒
擺|開
擺開來|攤心
擺闊|充撐
擺闊氣|讕闊佬
擾亂|滋擾
擾頓飯吃|黐餐
攀爬|擒
攀牆花類的總稱|纏藤花
攀登|擒
攀著|摱住
攀附|摱車邊
攆|拍
攏|括
攏絡|碼
攔|截
攔擋|柵
攔著我|攔住我
攔著|拉住
攔路搶劫|打腳骨
攙|摻
攙雜|勼亂
攛掇|媕
攜帶|帶同
攝像|攝錄
攝|影
攝影|攝錄
攢堆兒|埋堆
攢積|儲
攢聚|埋堆
攢錢|儲錢
攢集|埋堆
攣生女兒|孖女
攣生姐妹|孖女
攣生|孖生
攤兒|檔口
攤子|檔
攤開來放|炕
攤點兒|檔攤
攤點|攤檔
攪拌|勼亂
攪拌棍兒|攪攪捧
攪拌棒|攪攪捧
攪拌混凝土|搗石屎
攪|撈
攪笑|攪到滿天神佛
攬取|擸
攬頭攬頸|攬頭攬髻
支使|差使
支取薪水|受薪
支持不來|頂唔住
支持者|擁躉
支持|頂
支撐架|棚架
支撐|頂檔
支架橋梁的墩子|橋墩
支配|擺布
支離破碎|零星落索
收下|收晒
收不住口|把口唔收
收不回的賬|爛賬
收作業|收簿
收債|收數
收入來源|財路
收入|入息
收入少|奀
收入甚豐|豬籠入水
收到|收得
收口|埋口
收回債戶欠的錢|收數
收回債款|收數
收|執
收場|收科
收好|收埋
收尾|埋尾
收尾工作|手尾
收屍車|黑箱車
收拾他|擺平佢
收拾善後|埋尾
收拾在一起|擸
收拾|執嘢
收拾屍體|執屍
收拾心情|的起心肝
收拾殘局|執手尾
收拾爛攤子|執蘇州屎
收拾碗碟|執碟
收拾行李|執包袱
收拾起來|收埋
收據|收條
收攏|擸
收攤兒|收檔
收攤|執笠
收支相抵|夠本
收效|止到咳
收檔|收山
收款員|收銀員
收款者|櫃面
收生婆|執仔婆
收看所有|收晒
收破爛兒|收買佬
收穫|斬獲
收穫甚豐|大有斬獲
收縮|抽
收繳走私貨物|執私
收股息|收息
收舊貨|收買佬
收藏不用|雪藏
收藏|屏埋
收貨者|櫃面
收買|壅
收買破爛|收買佬
收費|收錢
收起來|收埋
收起|斂
收進|縮入
收集|儲
收集好|執齊
收集好資料|收齊料
收集簿子|收簿
收齊資料|收齊料
改口|反口
改天|揾日
改換工作單位|轉工
改換|轉
改用|轉用
改行|轉行
改變|轉
改錐|螺絲批
放下它|掉著佢
放下心頭大石|飲得杯落
放下|躉低
放不穩當|打躆跲
放了|放過
放假消息|放流電
放入|畀
放出風聲|放聲氣
放在心上|上心
放大嗓門亂說|大聲夾冇準
放學後留在學校|留堂
放屁|屙屁
放得下|放得低
放映|上畫
放榜|揭盅
放槍|燒槍
放涼|攤凍
放牛|睇牛
放牧|看
放監|出冊
放縱|放
放置緊湊|歸一
放置|躋
放肆地大發脾氣|發狼戾
放著|放住
放蕩|姣
放進滾水煮一下|拖水
放進|袋入
放長線釣大魚|放紙鷂
放開|鬆
放電影|映電影
放風聲|放聲氣
放高利貸的人|大耳窿
放高利貸者|大耳窿
放鬆|鬆
政府公共房屋|公屋
政府津貼學校|津校
故事|古仔
故去|過身
故意出洋相|整蠱做怪
故意刁難人|惡死
故意刁難|過唔去
故意|特登
故意與人為難|扭計
故意表現顯殷勤|讕殷勤
故鄉|鄉下
效仿|學
救不活了|沒有得救
救人性命|救到人
救火車|火燭車
救球|撲波
救生圈|救命圈
救護車|十字車
救護車的俗稱|十字車
敕法|變戲法
敗壞|搞廢
敗家子兒|佗衰家
敗家子|馱衰家
敗家|獻世
敗家者|佗衰家
敗火|制火
敗類|人渣
敘舊|聚舊
教你|醒你
教室|班房
教導|教落
教廷|梵蒂岡
教授方法|教法
教書匠|教書佬
教皇|教宗
教過|教落
敝姓|小姓
敝帚自珍|狗屎當乾薑
敞着口兒的雞籠|冇掩雞籠
敞篷車|開篷車
敞開懷|開懷解帶
敢於|夠膽
散亂|散修修
散了架子|甩皮甩骨
散了架|甩頭甩骨
散伙|拆檔
散工|散仔
散布謠言|畫花口面
散播|賣報紙
散檔|拆檔
散步|行街
散發|派
散銀|碎銀
散黃的蛋|涴蛋
敬請|敬希
敬辭|高
敲打|搉
敲打胸口|抌心口
敲擊|鑿
敲竹槓|撳鷓鴣
敲詐|勒
敲鐘|打鐘
敲鑼打鼓|打鑼打鼓
敲開|摼開
整人|整蠱
整個上午|成朝
整個人一動不動|定晒形
整個人|成身
整個愣住了|定晒形
整個早上|每朝
整個村子的人|成村人
整塊的眼皮|眼蓋
整天兒|一日到黑
整天想着錢|發錢寒
整天|成日
整|成
整所|全間
整整|足足
整整齊齊|齊葺葺
整數|齊頭數
整條街|通街
整治|剋治
整流器|火牛
整潔|企理
整班|全班
整理|整
整理賬目|做數
整理零碎東西|輯頭輯尾
整組|成班
整齊有序|歸一
整齊|齊整
敷|搕
敷衍|混
敷貼|罯
數位|數碼
斂|妠
文具尺|間尺
文具袋|筆袋
文字遊戲|捉字虱
文憑|沙紙
文昌魚|白飯魚
文明棍兒|士的
文章的結構|格局
文章|篇
文靜|靜
斗室|白鴿籠
斗眼兒|鬥雞眼
斗膽|得罪
料到|批中
料定|睇死
料想|料
料理|打理
斜向一邊|閘側
斜坡|斜
斜玉旁|王字邊
斜眼|眼䚕䚕
斜紋呢子|斜紋絨
斜肩|側膊
斜著|斜
斜視|猞
斜視的人|猞猁眼
斜領衣|斜襟衫
斜體|斜字
斟酌|參詳
斥測板|測板
斬切成塊狀|斬件
斬斷|斬纜
斬斷關係|斬纜
斬殺|劈友
斬首|斬頭
斯文而鎮定|斯文倓定
斯文|貴細
斯斯文文|官仔骨骨
斯洛維尼亞|斯洛文尼亞
斯諾克|士碌架
新上市|新出
新來乍到|初嚟暴到
新創意|搞作
新加入的人|新丁
新加坡|星加坡
新加坡貨幣|坡紙
新增|添加
新奇有趣|趣怪
新姑爺|新郎哥
新娘|新婦
新娘的蓋頭|頭帕
新娶的兒媳婦|新家嫂
新官上任三把火|新官上場整色水
新家|新屋
新崛起|新紮
新想法|新諗頭
新意思|搞作
新意|新意思
新房子|新屋
新手|初哥
新|新淨
新月|蛾眉月
新潮的理髮店|髮型屋
新的|新淨
新的血液|新血
新聞不斷|新聞多多
新近紅起來|新紮
新郎倌|新郎哥
新郎官|新郎哥
新郎|新郎哥
新郎的尊稱|新姑爺
新郎的母親|新奶奶
新郎的父親|新老爺
新雀|嫩雀
新鮮熱乎|新鮮熱辣
斷奶|戒奶
斷定|睇死
斷斷續續|死唔斷氣
斷根|斷尾
斷檔|斷市
斷炊|吊砂煲
斷絕|斷
斷貨|斷市
斷送前程|斷米路
斷頓兒|吊沙煲
方位|定
方便|就手
方便麵|即食麵
方向|路向
方塊兒|階磚
方塊|階磚
方式|法
方形長條麵包|枕頭包
方才|先至
方案|計劃
方正|四正
方片兒|階磚
方磚|階磚
方臉盤|國字口面
方言|話
方面|邊
於|向
於是就|於是乎
於是|於是乎
施加壓力|局
旁|側
旁邊兒|隔籬
旁邊|隔籬
旁門左道|偏門
旁門|橫門
旅店|客棧
旅行團|鴨仔團
旅費|水腳
旅遊汽車|旅行巴士
旅遊車|旅遊巴
旋兒|轉
旋編|爆肚
旋轉|篩
旋鈕|菂
既然說起來也就說吧|講開又講
日上三竿|黃朝百晏
日以繼夜|捱更抵夜
日光浴|曬太陽
日光燈|光管
日光燈管|光管
日夜工作|死捱死做
日夜盼望|日望夜望
日子不好過|唔得掂
日子好過|好景
日子|日
日常費用|使用
日式套餐|定食
日月暈|哄
日本人|日本仔
日本米酒|清酒
日班輪船|日船
日落|收熱頭
日記本|日記簿
日頭|熱頭
日食|日蝕
早一陣子|早排
早上好|早晨
早上|朝
早上飲茶|飲早茶
早不準備|臨急臨忙
早些天|先一牌
早些時候|較早時
早些時|在早
早先|先頭
早安|早晨
早就|一早就
早應該|該先
早操|晨運
早晚會東窗事發|上得山多終遇虎
早晚|遲早
早晨|晨早
早期|初時
早熟|老辣
早著呢|未有耐
早該如此|該先
早起|朝早
早陣子|前一輪
早飯|朝早飯
早點|朝早飯
旮旮旯旯的地方|窿窿罅罅
旮旯兒|角落頭
旱冰|滾軸溜冰
旱冰鞋|雪屐
旱鴨子|泥鴨
旺|猛
旺盛|猛
昆蟲|蟲蟲蟻蟻
明亮|光猛
明信片|甫士咭
明兒|聽日
明嘲|明村
明天上午|聽朝
明天|停日
明天早上|聽朝
明天晚上|聽晚
明太魚|柴魚
明年|出年
明早|聽朝
明明|明
明明白白|擺明
明晚|聽晚
明朗|爽
明白|明
明白該怎麼做|識做
明白過來|醒起
明目張膽|日光日白
明顯|擺明
昏天黑地|烏天黑地
昏昏欲睡|烏眉瞌睡
昏昏沉沉|昏昏沌沌
昏昏然|昏昏沌沌
昏暗|翳
昏迷|懵
易受騙者|老襯
易受驚|驚青
易壞|化學
易如反掌|易過借火
易怒|火頸
易為之事|小兒科
易發火|火頸
易看到|當眼
星期日|禮拜
星期|禮拜
星蟲|沙蟲
春光乍洩|走光
春捲皮|薄撐
春節|舊曆年
春聯兒|揮春
春聯|揮春
昧著|揞住
昨兒|尋日
昨天|尋日
昨天晚上|尋晚黑
昨晚上|尋晚夜
昨晚|尋晚
是一|係
是不是|係咪
是了|係啦
是什麼|係乜係物
是|係
是假事|就假
是假|就假
是假話|就假
是否|係勿
是吧|咯可
是味兒|和味
是啊|係喎
是嗎？|係咩？
是好是壞|食粥食飯
是對手|夠嚟
是樣兒|有形有款
是甚麼|係點
是非窩|是非啄
時不我待|時間冇多
時不時|耐唔耐
時壞|時好時差
時好時壞|一時好、一時壞
時常|周時
時時刻刻|分分鐘
時時如此|例牌
時興|在行
時裝表演|花生騷
時運到了末路|風水尾
時鐘|鐘
時間上的最後|最尾
時間不多|時間冇多
時間到|夠鐘
時間夠了|夠鐘
時間悠長|流流長
時間有限|時間冇多
時間短|霎時
時間表|檔期
時間|鐘數
時間限制|限時限刻
時髦|時興
時髦的青年男女|型男索女
時髦褲子|臘腸褲
晃來晃去|岌岌貢
晃動|岌岌貢
晃眼|巉眼
晃|霎
晉職|扎職
晌午|晏晝
晒台|天台
晚上|夜晚
晚半晌兒|夜晚黑
晚安|早唞
晚|晏
晚會|派對
晚熟|晚
晚睡|捱眼瞓
晚禮服|晚裝
晚稻|晚禾
晚節不保|臨天光攋尿
晚造稻子|晚禾
晚點|過鐘
晝短夜長|有朝冇晚
晦氣|冤口冤面
普吉島|布吉島
普普通通|麻麻地
普通|一般
普通湯|例湯
普通話|煲冬瓜
普遍|大路
景況好|順景
景泰藍|七寶燒
景象|街景
晴天|好天
晴|好天
晴雨衣|乾濕褸
晶體管|原子粒
智力平平|資質平庸
智囊|文膽
智巧型|醒目型
智能財產權|知識產權
智障少年|低能兒童
智齒|智慧牙
晾|㫰
晾乾|收水
晾放|炕
晾曬|曬㫰
晾涼|攤凍
晾著|攤凍
晾衣服|曬衫
晾衣架|衫架
暄|鬆化
暈乎乎|暈酡酡
暈倒|暈
暈眩|暈酡酡
暈船|暈船浪
暈車|暈車浪
暈車藥|暈浪丸
暈頭轉向|暈晒大浪
暈頭轉者|失魂魚
暈頭|頭暈暈
暈飛機|暈機浪
暑假休息|歇暑
暑親|焗暑
暖和|和暖
暖壺|暖水壺
暖帽|雪帽
暖水壺|熱水壺
暖水瓶|熱水壺
暖洋洋|暖粒粒
暖烘烘|暖衲衲
暖瓶|暖水壺
暗中串通好|扯貓尾
暗中使壞|整古
暗中做小動作|整色整水
暗中算計|閹
暗娼|雞
暗棋|盲棋
暗溝|坑渠
暗瘡|青春豆
暗算別人|起後腳
暗號|記認
暗諷|暗村
暗通消息|通水
暗黃|黃黚黚
暢快|爽
暢銷|熱賣
暫且|自
暫且這樣|係噉先喇
暫住|落腳
暫時停止營業|收檔
暫時替人付錢|墊
暫時閑置|雪藏
暫時離開|行開一陣先
暫離|冇玩
暫離"|行開陣先
暱稱|網名
暴怒|爆火
暴牙|齙牙
暴發戶|新發家
暴跳如雷|扎扎跳
暴躁|火爆
暴露|踢爆
曆書|通勝
曖昧的事|景轟
曠工|偷雞
曠課|偷雞
曬台|天台
曬棚|天棚
曬臺|天臺
曲別針|萬字夾
曲尺手槍|航空曲
更加|愈發
更夫|老更
更好|尚好
更換|更換
更改|更改
更新|更新
更新銀行存摺簿資料|打簿
更|更加
書呆子|書蟲
書報攤|報紙檔
書本|本書
曼島|萌島
曾出現過|試過
曾外祖母|阿太
曾孫|塞
曾有過|試過
曾祖母|太婆
曾祖父|太爺
曾經有過|舊
曾經歷過|試過
曾經|試過
替上|頂上
替人捧場者|抬轎佬
替人服役|做驢仔
替人行兇者|橫手
替代|頂包
替你|戥你
替|幫
最上面|最面
最倒霉|最弊
最初|先時
最前面的房間|頭房
最前頭的位置|頭位
最厲害|最應
最可憐|最慘
最合潮流|至IN
最吸引人|為人
最壞|最弊
最壞的人|人渣
最大|大晒
最好"|好晒
最好是|至好
最好|至好
最小|孻
最小的兒子|孻仔
最小的女兒|孻女
最少|至細
最差|最衰
最年長的姐姐|大姐
最強的人|一哥
最後一個|包尾
最後一名|包尾
最後一場|尾場
最後一班|尾班
最後|包尾
最後呼叫|最後召集
最後的位置|孻尾
最後的運氣|尾運
最快|快且
最怕|最忌
最悲慘|最慘
最愛錢|睇錢緊
最拿手的戲|手本戲
最早的食用澱粉|菱粉
最時髦|至IN
最有權威的人|一哥
最有能耐的人|一哥
最末|孻尾
最末尾|後尾
最末班的渡船|尾渡
最棒|一流
最次|呀呀烏
最次的貨|水尾嘢
最流行|至IN
最淒慘|最慘
最痛|最應
最糟|最弊
最終|卒之
最能幹|至叻
最|至
最裏邊|篤底
最裏間的房子|尾房
最裏頭|尾底
最要緊|最緊要
最近|最近
最近這些日子|呢牌
最遲|至遲
最重要|首要
最高層人員|老頂
最高|最頂
會享受|識歎
會做人|熟性
會做|識做
會功課|識書
會動|識喐
會取巧|精
會品評|會飲會食
會哄人|口甜舌滑
會妖術者|敕法佬
會將|會
會帳|睇數
會往上爬|識撈
會按時打響的錶|鬧錶
會挑選食物|揀飲識食
會掙錢|識撈
會是呢|呢可
會發出響聲|鬧
會盤算|精
會算計者|密底算盤
會鑽營|識撈
會開合眼的娃娃|蹔眼公仔
會養生|惜身
月亮|月光
月分|月份
月初|月頭
月底|月尾
月|月頭
月桂樹|月桂
月牙兒|蛾眉月
月經|姑婆
月經期|例假
月色朦朧|月光生毛
月芽兒|蛾眉月
月食|月蝕
月餅|月
有一兒一女|湊夠一個好字
有一天|有日
有一手|耍得
有一|有啲
有一種|有隻
有一群|有班
有一說一、有二說二|有碗話碗有碟話碟
有一點兒|有少少
有一點|有少許
有一點點|有啲咁多
有主人|有頭有主
有主兒|有頭有主
有主意|有腸肚
有了意思|起心
有些傻氣|傻瓜瓜
有些小病|唔自然
有些|有啲
有些過份|有點兒那個
有交道可打|有交易
有人說|有人話
有什麼不同|有咩唔同
有什麼困難|有嘢唔妥
有什麼|有冇咩
有仇|有仇口
有份兒|有份
有份量的人|大粒佬
有何看法|點睇
有來由|有頭有路
有便宜可佔|有着數
有便宜|有着數
有便意|急屎
有信用|有口齒
有個屁|有鬼
有個鬼|有鬼
有倒塌危險的房子|危樓
有倚靠|有把炮
有傲視他人之意|焦即
有價值|矜貴
有光澤|油潤
有內容|有料到
有內涵|有料到
有兩下子|有兩手
有兩種可能|兩睇
有其人則必有其物|物似主人形
有出息|識性
有分寸|有紋路
有利可圖|有着數
有前勁沒後勁|有頭冇尾
有剩餘|有剩
有創造性|創意
有力|力駁
有力氣|夠氣夠力
有勁|勁
有勞您|唔該
有勢力|猛嘢
有勢力者|大哥大
有口福|夠口福
有可能|有之
有吃的|有得吃
有名人物|猛人
有名|出名
有名有利|名成利就
有名望|有面
有咬勁兒|彈牙
有問題|唔係路
有地位|有面
有多亮眼|幾醒
有多餘|有突
有多高|幾高
有天壤之別|差天共地
有失面子|低威
有始有終|有頭有尾
有始無終|有頭冇尾
有姘夫的女人|野貓
有威望|拫
有威風|夠威
有孔洞可通|通窿
有孕|馱仔
有學問|有料
有官少爺氣味|官仔
有富餘|有多
有尿意|急尿
有希望|有聲氣
有干係|關事
有幾回|有幾何
有後臺|腰骨硬
有心勁|心水清
有心計|有腸肚
有情況|有古怪
有想要|有意
有意思|有癮
有意搗亂|胡混
有意見|條氣唔順
有感情|有心
有|成
有所恃|有大山挨
有所收獲|有料到
有手藝的人|師傅
有才幹|有料
有才幹的人|一哥
有技能|有兩手
有把握|有把炮
有效應|靈擎
有效|殺食
有文化|知書識墨
有文章|講話有骨
有新意|創意
有時候|一時時
有時刻限制|限時限刻
有時|間中
有時間|得閒
有朝一日|他朝
有本事|使得
有本領|有兩度
有板有眼|有紋有路
有條有理|有頭有路
有條理|企理
有樣本看|有辦你睇
有橫條|間條
有正當職業|做正行
有武功|有兩度
有毛病|神神地
有氣派|威水
有氣無力|有神冇氣
有求必應|黃大仙
有決斷|爽脆
有沒有弄錯|有冇搞錯
有沒有|有冇
有沒有空|得唔得閒
有法子|有路數
有洞|有窿
有派|夠派
有派頭|有型
有消息|有聲氣
有消息說|有傳
有煽動性|煽情
有特色|有型
有狗牙邊|起狗牙
有玩的|有得玩
有用意|講話有骨
有用|等使
有病|唔自在
有癖好|有癮
有癮頭|有癮
有的是|大把
有直接血緣|親生
有看頭|有睇頭
有眼力|帶眼
有瞄頭|有睇頭
有福共享|分甘同味
有福氣|托賴
有福相|好福厚
有秩序|企理
有種|夠薑
有積|生積
有空來坐|得閑嚟坐
有空兒|得閒
有空|得閒
有窟窿|有窿
有立體感|玲瓏浮突
有精力|有心機
有經驗|在行
有義氣|為得朋友
有耐心|有心機
有聲氣|有行
有股味道|有陣味
有能力做|做得嚟
有能力|曉
有能耐|手硬
有膽量|夠膽
有臉面|有面
有自己一份|有份
有興趣|有癮
有著|有住
有蓋的溫酒器|酒盅
有蓋茶碗|焗盅
有螺紋的釘子|螺絲釘
有誠意|神心
有說有笑|有傾有講
有貨賣|有得賣
有貶有褒|有彈有讚
有資格|有料
有趣|過癮
有足夠氣力|夠力
有路達到|通
有身孕|有身己
有辦法|有術
有退休金養老|食長糧
有進展|有料到
有運氣|有運
有道是|開口有話
有遮蔭|有蓋
有錢人太太|闊太
有錢人|闊佬
有錢女人|富婆
有錢就花|手指罅疏
有錢有勢|有錢有面
有錢|沓水
有錢的單身男子|鑽石王老五
有門兒|有行
有門路|有路數
有關係|關事
有關於|事關
有阻力|濕滯
有難解決的事|囉攣
有零錢找|有找
有靠山|有大山挨
有靠背的椅子|挨憑椅
有預見性|知機
有頭有臉|有頭有面
有頭無尾|冇腰骨
有頭腦|有腸肚
有餘|有突
有骨氣|腰骨硬
有高腿|高腳
有鬼主意|縮骨
有鬼物出沒|污糟
有麻煩|濕滯
有點兒|有啲
有點奇怪|有點兒那個
有點悶|悶悶地
有點技能|有幾手嘢
有點本事|有幾手嘢
有點辣|辣辣哋
朋友|友記
服了你了|保你大
服務員|侍應生
服務生|伙記
服帖|帖服
服氣|順氣
服輸|執輸
望潮|八爪魚
望|眈
望風|睇水
朝天椒|指天椒
朝奉|老奉
期終考試|大考
朦朦朧朧|矇查查
木偶戲|鬼仔戲
木匠|鬥木佬
木屑|木糠
木履|履
木工|鬥木
木方|方
木板手推車|豬籠車
木柱子|戙
木柱|棟
木柴|柴
木棉|紅棉
木橛子|樴
木瓜|萬壽果
木紗團|線轆
木耳的通稱|雲耳
木耳|雲耳
木訥|一轆木
木雞|傻雞
木頭人兒|四方木
木頭木腦|木獨
未上油漆|光身
未來|來
未來的收支計劃|預算
未做完的事|手尾
未儲存|未記妥
未婚同居|住埋
未肯安定|騎牛搵馬
未過門|未入門
末了|孻尾
末尾|後尾
末批|尾水
末期|尾
本事不大|三板斧
本事|斤兩
本人|份人
本來|原底
本來應該|本應
本來沒事|猶自可
本子|簿
本家|老宗
本該|先該
本|部
本金|本銀
本錢|本銀
本領不高|三板斧
本領|喉底
朽了|霉
杉木|杉
杉篙|杉
李四|阿貓
材料|料兆
杓兒|匙羹
束手無策|冇符
束緊褲腰的帶子|褲頭帶
束縛|綁
杯子|杯
杯柄|杯耳
杯珓|杯
杯裝的方便麵|杯麵
杯麵|杯仔麵
東倒西歪|離行離捺
東加|湯加
東奔西忙|頻頻撲撲
東家|老細
東張西望|覘天望地
東扯西扯|噏三噏四
東拉西扯|發牙痕
東搬西搬虧了一半|上屋搬下屋唔見一籮穀
東西|嘢
東走西竄|亂咁舂
松針|鬆毛
板上釘釘|實牙實齒
板擦兒|粉擦
板擦|粉擦
板板六十四|死牛一便頸
板栗|風栗
板油|豬膏
板球|木球
板腰|拗腰
板著臉|面燶燶
板起臉孔|黑口黑面
枇杷果|蘆橘
枉|屈
枉稱|屈
枉讀詩書|讀枉書
枕頭套|枕頭袋
枕頭|睡枕
枕頭芯子|枕頭肉
枕頭袋子|枕頭袋
果仁兒|銀
果凍|啫喱
果名|桂木
果子|生果
果子醬|果占
果核|核
果醬|果占
枝圓|荔枝乾
枯朽|枯
架勢|架步
架子床|碌架床
架子|款頭
架床|行床
架拐子|鬆㬹
架起|啷
枸杞子|杞子
某些|啲
某些膽形的東西|膽
某些鉗子|弶
某些青菜的嫩心|膽
某個|個
某某人|乜誰
某某|阿乜人
染頭髮|染髮
柔勁|陰力
柔枝嫩莖|軟
柔細|幼細
柔軟|軟熟
柔魚|魷魚
柚子的一種|桑麻柚
柚子皮|柚皮
柚子|碌柚
柝|鐸
查對|點
查德|乍得
查戶口|查家宅
查|搵
查架|打交
柱子的基石|柱墩
柴油機車|油渣車
柴火|柴
柴灰|爐灰
柴草|柴
柴|豆泥
柵亂歌柄|劖亂歌柄
柵欄|欄河
柿子|柿
柿子椒|燈籠椒
栗子|風栗
栗臉皮|面皮厚
校務員|校工
校正|校
校準|調
校車|校巴
株|樖
核桃|合桃
根基|底
根據|根底
根本|直情
根治|斷尾
格外|零舍
格子旗|格仔
格子|格仔
格格|揭揭聲
格瑞那丁|格林內丁斯
格瑞那達|格林納達
栽下水|蹱落水
栽培|帶挈
栽|舂
桂圓肉|圓肉
桂花味道|桂味
桂花|月桂
框住|框
案件|個案
案例|畸士
案子|畸士
桌子|枱
桌布|牆紙
桌|枱
桌球|台球
桌球房|波樓
桐油罐子無二用|桐油埕裝桐油
桑椹|桑棗
桔紅色|金魚黃
桶底|桶篤
梅雨天|長命雨
梗塞|哽
梗|莢
條子|條
條狀嫩肉|柳
條狀花紋|柳條
條碼|條型碼
條紋相間|一間間
條紋|間條
條|隻
梨子|雪梨
梨|雪梨
梯子|梯
梯級|步級
械鬥|開片
梳子|梳
梳理|梳
梳理髮辮|梳辮
梳辮子|紮辮
梳辮|長辮
棉大衣|棉褸
棉布便鞋|懶佬鞋
棉猴兒|雪褸
棉絮|棉胎
棉背心|龜背
棉花套子|棉胎
棉衣|棉衲
棉被的外套|被袋
棉襖|棉衲
棍兒糖|波棒糖
棒個屁|叻鬼咩
棒糖|波棒糖
棘手|澀滯
棱角絲瓜|勝瓜
棵|樖
棺材|壽木
棺材板|壽板
棺材瓤子|棺材餡
椅子|挨屏椅
椅子牚|椅橫
椅子的扶手|椅手
椅子的靠背|挨屏
椅子腿兒|椅腳
椅子靠背|椅憑
植物的根部|頭
植物的芽或果|枅
植物的蔓|藤
椰子的硬殼|椰殼
椰子肉末|椰茸
椰樹的果實|椰子
椽子|桁桷
楔子|櫼
業主|屋主
業餘兼職|秘撈
極了|晒
極倒楣|衰到貼地
極傻的人|大懵
極像|十足十
極其|極之
極其淺顯|一字咁淺
極其驚慎|魂魄唔齊
極力吹噓|力捧
極匹配|襯到絕
極厲害|飛起
極可能|九成
極吝嗇的人|鐵沙梨
極好|冇得彈
極害怕|震揗揗
極少|幾微
極少量|點
極差|極其之差
極度|極
極快|飛
極愚蠢|蠢到加零一
極懵懂|懵上心口
極懶的人|蛇王
極暗|黑咪麻
極涼快|浸浸涼
極為便宜|爛賤
極為倒楣|黑過墨斗
極為合襯|襯到絕
極為容易|易過借火
極為從容鎮定|定過抬油
極為懊悔|抌心口
極為|鬼咁
極疼愛的孩子|心肝椗
極瘦的人|鶴
極短的時間|轉眼
極短的袖子|雞翼袖
極端|拫
極端無知的人|大傻
極細的精鹽|淮鹽
極細的豆餡|豆茸
極臭|冤臭
極言其多|幾十百
極言其少|釐
極言好聽|聽出耳油
極言相隔之遠|離天九丈遠
極賤|爛賤
極遠處|冇雷公咁遠
極遲|蛇都死
極重|夠勁
極限|舋
極飽|飽到上心口
極高|頂級
榆木腦袋|石屎頭腦
榆樹的果實|榆錢
榜樣|人辦
榮辱與共|同撈同煲
槌子|槌
槍戰|開火
槍手|替槍
槍斃|打靶
槍替|替槍
槍|炮
槍烏賊|魷魚
樂一樂|得啖笑
樂事|一樂也
樂善好施|好衣食
樂得|宜得
樂於助人|好相就
樂於幫助別人|為得人
樂極生悲|玩出禍
樂觀|大癲大廢
樂隊|班
樓下|地下
樓房分期供款|供樓
樓房|樓宇
樓房的底層|地下
標新立異|出位
標記|嘜頭
標誌|嘜頭
標貼|標籤
樟腦丸|臭丸
樟腦|臭丸
模仿別人說話|學口學舌
模仿|學似
模本|模版
模棱兩可|兩開
模樣|鋪
模樣難看|騎喱
模糊|朦
模里西斯|毛里裘斯
樣品|示範
樣品米|米辦
樣品酒|酒辦
樣子很醜|好樣衰
樣子時髦|時款
樣子|樣
樣本|板
樣本碟|試玩碟
樣板|人辦
樣樣兒|瓣瓣
樣樣精通、樣樣稀鬆|周身刀、冇把利
樸實|踏實
樹下的陰涼地|樹陰
樹杈|樹椏
樹枝椏|樹椏
樹梢|樹尾
樹的最高處|樹頂
樹的氣根|樹鬚
樹粧|樹頭
樹苗|樹仔
樹莓|紅桑子
橄欖|欖
橋墩|橋躉
橋梁|橋
橘子|橙
橙子|橙
橙黃色|金魚黃
機伶|靈機
機動帆船|機帆
機器人|機械人
機器腳踏車|電單車
機器|部機
機巧而滑稽|鬼馬
機智而滑稽|生鬼
機會|路數
機箱|機殼
機製炒米|肥仔米
機警|醒目
機靈而滑稽|鬼馬
機靈|醒目
機靈鬼|醒目仔
橡皮圈兒|橡筋箍
橡皮圈|膠箍
橡皮擦|擦膠
橡皮筋兒|橡筋箍
橡皮筋圈|橡筋箍
橡皮筋|橡筋
橡皮|膠擦
橡皮膠|擦紙膠
橡皮魚|剝皮牛
橡膠|橡筋
橡膠水管|膠喉
橢圓形|扁圓形
橫七豎八地亂放|打橫打掂
橫七豎八|打橫打掂
橫下一條心|立實心腸
橫寫的外文|雞腸
橫幅|橫額
橫放|打橫
橫木|憑
橫格兒|間條
橫眉怒目|瞪眉突眼
橫眉豎目|覴眉突眼
橫著|打橫
橫行|牛王
橫行霸道|蝦蝦霸霸
橫豎也是死|橫又死、掂又死
橫豎|橫掂
橫豎要死|橫又死、掂又死
橫豎都是死|橫又係死、掂又係死
橫躺下來|倒
檔子|鋪
檔案|快勞
檔次|級數
檢察視力|考眼界
檢查|查
檢查…|查下…
檢查身體|驗身
檢漏|執漏
檢現成兒|執死雞
檢視全部|望晒
檢視|望埋
檯球|士碌架
檯面|大枱
檳榔芋|荔浦芋
櫃上|櫃面
櫃台|櫃面
櫃員|企枱
櫃子上|櫃面
櫃子|櫃
櫃子裏|櫃筒
櫃檯|櫃位
櫃面|徛櫃
櫥窗|飾櫃
櫻桃|車厘子
欄杆兒|欄河
欄杆|欄河
權威|威勢
欖豉|欖角
欠債人|債仔
欠債的人|債仔
欠款|收數
欠|爭
欠缺|欠奉
欠賬不還|賴賬
欠錢不還|賴
次品|流嘢
次等貨|二水貨
次級品|苴斗貨
次貨品|籮底橙
次貨|流嘢
次透了|衰到唔使欿
欲望大|開胃
欲言又止|咿咿哦哦
欺負人|蝦蝦霸霸
欺負|狎
欺騙人|滾紅滾綠
欺騙|揾笨
款式入時|時款
款式很好|有型有款
款式|花款
歇後語|背語
歇息|唞
歇|抖
歉意|道歉
歌兒|歌仔
歌唱的基本功|喉底
歌曲|歌仔
歐洲藍莓|山桑子
歡喜冤家|鬥氣冤家
歡蹦亂跳|生猛
止住|懫
止瀉|止痾
正下著|溚緊
正合|開正
正圓|整圓
正在下載|取得緊
正在使用|用緊
正在做|做緊
正在傳送|傳送緊
正在共用|共用緊
正在分享|分享緊
正在反應|反應緊
正在啟用|啟用緊
正在執行|行緊
正在存取|存取緊
正在學|學緊
正在建立|建立緊
正在思考|諗緊
正在打開|打開緊
正在投放|投放緊
正在掃描|掃描緊
正在排隊時|排排下隊
正在控制|控制緊
正在擷取|擷取緊
正在更新|更新緊
正在檢查|查緊
正在|正係
正在瀏覽|瀏覽緊
正在玩|玩緊
正在看|睇開
正在等候|等候緊
正在等待|等待緊
正在翻譯|翻譯緊
正在處理|處理緊
正在解析|解析緊
正在診斷|診斷緊
正在說|講緊
正在載入|載入緊
正在追蹤|追蹤緊
正在連線|連緊綫
正在驗證|驗證緊
正好|正正
正如所說|話齋
正妻|大婆
正宗|正牌
正室|大婆
正常|好人好姐
正式拍攝|埋位
正式開拍|埋位
正想|正其想
正撞上|撞正
正方形|四方形
正方|整方
正是|正正是
正月期間|新正頭
正派|正經
正牌|正斗
正當的行業|正行
正碰上|撞正
正確|啱路
正要|正話
正規|正斗
正規表示式|正則表達式
正面朝上|反仰
正項以外|雜
此刻|這刻
此次|今次
步行|行路
武功|功夫仔
武器之一|炮
武打演員|打仔明星
武藝|功夫
武術|功夫
武術散打|散手
歪七扭八|扭橫折曲
歪斜|歪
歪曲事實|戾橫折曲
歪曲|拗橫
歪歪斜斜|歪哩歪斜
歲|勾
歸根結底|一日到黑
歸置|執拾
歸|還
歸還|還
死不了|死唔去
死不瞑目|死唔眼閉
死丫頭|衰女包
死了|瓜直
死亡|歸西
死人的頭骨|骷顱頭
死人頭骨|死人骨
死光光|死晒
死去活來|死過返生
死在街上|仆街
死在路上|仆街
死定了|實死冇生
死家伙|死人嘢
死對頭|對頭人
死就死吧|打死罷就
死心|心息
死掉|死光
死有餘辜|抵死
死東西|死人嘢
死板地背誦|唸口簧
死板|執滯
死死|死咁
死氣沉沉|死咕咕
死沉死沉|一力扚
死沉|重耷耷
死磨硬磨|死纏爛打
死結|死綟
死絕了|冚家鏟
死給他看|死過佢睇
死纏|死跟
死者|死佬
死而瞑目|死得眼閉
死背|唸口簧
死胡同|屈頭路
死裏逃生|死過翻生
死記硬背|死背
死路|屈頭路
死頂着|死撐
死鬼|死佬
殘忍|冇陰功
殘渣|腳
殘舊|爛鬼
殘貨|水尾
段兒|橛
殷切盼望|望到鶴噉頸
殺了威風|失威
殺人|冧友
殺人精|殺人王
殺光|殺晒
殺雞|劏雞
殺魚|劏魚
殼|莢
殼菜|青口
毀約|踢契
毅力|長蓬力
母狗|狗乸
母貓|貓乸
母雞|雞乸
每一個人|人人
每一個|個個
每一處|度度
每五分鐘|字
每件事情|樣樣事
每件事|樣樣事
每件|件件
每個人|係人
每個|個個
每個早上|每朝
每天早上|每朝
每天|朝朝
每層兩個單位|一梯兩伙
每方面|瓣瓣
每日|日日
每日的花費|皮費
每時每刻|分分鐘
每樣|瓣瓣
每次|親
每種|每隻
每逢|親
每間|間間
毒品|白粉
毒蛇名|過山峰
比不上他|唔似
比不上|唔及
比不過|唔夠
比他們更聰明|㔹過佢哋
比他更聰明|㔹過佢
比價|格價
比其他活動還要多|尚多過第啲活動
比分|比數
比別人差|執輸
比地位高|鬥大
比基尼|比堅尼
比基尼泳衣|兩件頭
比它們更聰明|㔹過佢
比它多|多過佢
比它大|大過佢
比它好|好過佢
比它快|快過佢
比它更聰明|㔹過佢
比它高|高過佢
比得上|拍得住
比快|鬥快
比排場|鬥架勢
比方說|比如話
比武的場所|擂臺
比漂亮|鬥靚
比珍珠還真|珍珠都冇咁真
比目魚乾|大地魚
比目魚|龍脷魚
比真正需要還多|尚多過真係需要
比美|鬥靚
比腕力|拗手瓜
比薩餅|披莎
比賽|作賽
比較便宜|平過佢
比較價錢|格價
比較困難|難過佢
比較固定|例牌
比較多|多過佢
比較大|大過佢
比較好|好過佢
比較容易|易過佢
比較快|快過佢
比較|比併
比較簡單|簡過佢
比較高|高過佢
比|過
比重大|重身
比重小|輕身
比闊氣|鬥架勢
毛坑|屎坑
毛孔|毛管
毛巾布襯衫|毛巾恤
毛巾被|珠被
毛手毛腳|雞手鴨腳
毛料|薄絨
毛毛蟲|狗毛蟲
毛毛躁躁|媌神
毛毛雨|溦溦雨
毛毯|氈
毛瓜|節瓜
毛皮大衣|雪褸
毛皮服裝|皮草
毛皮的底板|皮板
毛皮|皮草
毛竹|茅竹
毛筆|墨筆
毛筆字|大字
毛細|微絲
毛絨娃娃|毛毛公仔
毛絨玩具|毛公仔
毛絨絨|毛鬙鬙
毛綫|毛冷
毛線|毛冷
毛腰|烏低身
毛茸茸|毛鬙鬙
毛蟹|大閘蟹
毛衣|冷衫
毛躁|媌神
毫不留情|一戙都冇
毫不相干|冇相干
毫無價值之事者|雞仔媒人
毫無生氣|死咕咕
毫無眉目的事情|冇米粥
毫無起色|死咕咕
毫無辦法|冇晒符
毫無關係|冇挐冇掕
毫米|米厘
民國時低面值錢幣|碎錢
民間|坊間
民間樂隊|八音
民間音樂|八音
氣不舒|慍氣
氣不過|唔抵得
氣不順|鼓住道氣
氣力不足|唔夠氣
氣勢|勢
氣勢洶洶|惡死
氣味相投|攪得埋
氣味|隨
氣喘吁吁|氣羅氣喘
氣喘如牛|口擘擘
氣喘|欶氣
氣墊船|飛翼船
氣壞了|激死
氣壞|吹脹
氣定神閒|坐定粒六
氣得|嬲到
氣得火冒三丈|眼火爆
氣得火往上躥|眼火熛
氣得跳腳|獳沙
氣息|氣
氣惱|勞氣
氣憤|火滾
氣憤難平|不憤氣
氣死了|吹爆
氣死|激生
氣派十足|夠派頭
氣派|威水
氣溫|天口
氣筒子|氣泵
氣筒|氣泵
氣糊塗了|火遮眼
氣結|勞氣
氣結敗壞|滾水淥腳
氣色好|好氣色
氣色|色水
氣質高貴|貴格
氣量小|小器
氣量很小|好小器
氣門|喉嘴
氣門心|喉嘴
氣體|氣
氣鼓鼓|獳爆爆
氣鼓鼓的人|鼓氣袋
氯仿|哥羅仿
氰化物|生埃
氰化鉀|山埃
水上居民|蜑家
水上飛行船|飛翼船
水中撈月|海底摸月
水中種的蕹菜|水蕹
水份少|乾水
水來土掩|見招拆招
水分很少|乾
水坑|水氹
水垢|水垽
水壺|水煲
水平一般|麻麻哋
水平低劣|水
水平低|苴皮
水平|質素
水平高|勁抽
水平高許多|高幾班
水庫|水塘
水患|水浸
水或雲氣冒出來|湧
水果兒|生果
水果名|荔枝
水果批發店|果欄
水果批發行|果欄
水果|生果
水母|白䖳
水氣|濕氣
水泡兒|水泡
水泥森林|石屎森林
水泥|紅毛泥
水流聲|化化聲
水淋淋|水渧渧
水溝|溝渠
水煮|煠
水產貨棧|魚欄
水痘|水泡
水管|喉管
水缸|甕缸
水草|鹹水草
水蒸氣或水燙|煋
水蒸氣灼|煪
水蔊菜|西洋菜
水藥|湯藥
水蚤|紅蟲
水蝨|紅蟲
水路走私者|水客
水退|水落
水鍋|水煲
水開|水滾
水雞雞|朘仔
水麵筋|麵筋
水龍|滅火喉
水龍頭|水喉
水龜|金錢龜
永久|永久
求助|幫手
求神許願|作福
求神降福|祈福
汗味濃|鹹
汗垢|老泥
汗孔|毛管
汗流浹背|身水身汗
汗淋淋|身水身汗
汗漬|哄
汗禢兒|底衫
汗臭味|宿
汗臭|餿
汗衫兒|笠衫
汗衫|笠衫
汙|污
汞溴紅|紅汞水
江|海
江湖客|江湖佬
江湖醫生|黃綠醫生
江湖騙子|老千
江珧貝|帶子
江米做的甜酒|糯米甜酒
江米做的甜醋|糯米甜醋
江米|糯米
江邊|海皮
池塘養的魚|塘魚
池子|塘
池鷺|夜游鶴
污染|染污
污水渠|坑渠
污穢|爛
決定成敗|定生死
決定|決計
決心去做某事|有所謂
決心大|幾大
決心|立心
決意|實行
汽槍|風槍
汽水|梳打
汽油|電油
汽燈|大光燈
汽船|電船
汽車倒車|褪車
汽車|架車
汽車的檔|波
沉得住氣|老定
沉悶的氣氛|悶局
沉|沈
沉沙井|沙井
沉浮興衰|三衰六旺
沉甸甸|重耷耷
沉迷於賭博|爛賭
沉重|翳
沏茶|沖茶
沒一刻安生|冇時閑
沒下雨|冇雨落
沒了主意|心大心細
沒了看到|唔覺眼
沒事兒|冇嘢
沒事兒找事兒|唔衰搵嚟衰
沒事|冇嘢
沒事找事|冇蝨搵蝨撓
沒二話|冇乜兩句
沒人|冇人
沒人性|冇性
沒人情味|唔臭米氣
沒人管|冇王管
沒什可怕|冇有怕
沒什麼了不起|沒所謂
沒什麼"|冇乜嘢
沒什麼|冇咩
沒什麼可說|冇話頭
沒什麼特別|冇乜點
沒來往|冇交易
沒信用|冇口齒
沒信義|冇腰骨
沒個準|冇譜
沒個準點兒|冇時冇候
沒倚靠|冇下落
沒做|未做
沒內容|冇料到
沒出事兒|冇事
沒出息|唔生性
沒別的原因|冇他
沒別的緣故|冇他
沒勁|冇心機
沒動靜|冇聲氣
沒原則|冇腰骨
沒吃夠|到喉唔到肺
沒吃完|食剩
沒吃頭|冇食頭
沒合眼|眼光光
沒味道|冇聞冇味
沒咒兒念|冇符
沒商量|冇得講
沒問題|冇問題
沒回音|冇聲氣
沒多久|冇幾耐
沒多大能耐|三板斧
沒多長時間|冇耐
沒大沒小|冇大冇細
沒好死|不得好死
沒好的吃|冇啖好食
沒好處|冇益
沒學問|冇料
沒學行就學走|未學行先學走
沒安好心|唔好心
沒完成|搞橫
沒家教|冇家教
沒展開|縮
沒工夫|唔得閑
沒希望|冇聲氣
沒幾回|冇幾何
沒弄清楚|擺烏龍
沒得說|冇得彈
沒心思|冇晒心機
沒心情|冇心機
沒心眼兒|冇腦
沒心肝|竹織鴨
沒必要|使乜
沒怎麼|冇乜
沒想到|誰不知
沒意思|冇癮
沒意見|氣順
沒拘束|冇拘冇管
沒招兒|冇橋
沒招數|冇橋
沒指望|冇行
沒救了|沒有得救
沒教養|冇家教
沒料|冇料
沒時間|冇時
沒有一刻|冇時
沒有人性|冇性
沒有人監管|冇皇管
沒有什麼不好|冇壞
沒有什麼|冇乜
沒有什麼可談|冇得傾
沒有任何|冇
沒有任何東西可|冇嘢好
沒有作弊|冇出貓
沒有來由|冇端端
沒有價錢可講|冇得傾
沒有光澤|啞色
沒有其他原因|冇他
沒有|冇
沒有別的緣故|冇他
沒有吃光|未吃完
沒有固定的時候|冇時定
沒有壞處|冇壞嘅
沒有多少|冇乜滯
沒有大的錯處|冇大錯
沒有完成|未完
沒有尖兒|屈
沒有我的份兒|沒有我份
沒有或罕有之事|雞屙尿
沒有智慧|冇腦
沒有根據|冇嚟由
沒有格子的本子|拍紙簿
沒有毛髮|光禿碌
沒有水分|乾
沒有活動地方|冇走趲
沒有燈火|烏燈黑火
沒有牽累|乾手淨腳
沒有理會|沒理
沒有理由|冇理由
沒有甚麼能抵擋它|冇得頂
沒有甚麼能超過它|冇得頂
沒有甚麼關係|唔相干
沒有用|唔等使
沒有留意|不為意
沒有的話|唔係噉講
沒有真心的人|竹織鴨
沒有真本事|冇料到
沒有空|唔得閒
沒有穿上衣|打大赤肋
沒有米的稀飯|冇米粥
沒有纍贅|乾手淨腳
沒有耐心|冇好氣
沒有聲響|靜
沒有膽量的匪徒|冇膽匪類
沒有解決不了的問題|船到橋頭自然直
沒有話可說|冇得講
沒有談判的餘地|冇得講
沒有買賣關係|冇交易
沒有賺頭|微
沒有辦法|一棟都冇
沒有遮攔|冇遮冇掩
沒有邊的竹帽|帽殼
沒有長遠打算|見步行步
沒有關係|冇相干
沒有頭緒|冇厘頭
沒有骨氣|軟皮蛇
沒有鬆動的時間|冇走趲
沒本事|冇斤兩
沒模樣了|落晒形
沒正經|冇搭颯
沒歸宿|冇下落
沒水平|冇料
沒法兒比|冇得頂
沒法子|冇橋
沒法子相比|冇得比
沒注意|冇留意
沒注意到|唔覺眼
沒活幹|冇得撈
沒消息|冇聲氣
沒準兒|冇譜
沒理由|冇理由
沒甚麼可指摘|冇得彈
沒甚麼好商量|冇得傾
沒甚麼希望|凍過水
沒生意|拋錨
沒用|冇用
沒用的人|廢柴
沒用的貨|沒用怪
沒留意|唔覺眼
沒癮頭|冇癮
沒的說|冇計嘅
沒看到|睇漏眼
沒看見|唔見
沒看頭|冇睇頭
沒真本事|冇料
沒眼力|冇眼界
沒着落|冇着落
沒睡醒|未醒
沒禮貌|唔斯文
沒空|唔得閑
沒空閑|冇時
沒精打彩|冇厘神氣
沒精神|冇精神
沒羞|唔知醜
沒聯繫|唔相干
沒胃口|冇飯癮
沒能參加|失拖
沒能耐|冇料
沒脊梁骨|冇腰骨
沒腦子|冇腦
沒腦筋|腦囟未生埋
沒臉|冇面
沒興致|冇心機
沒興趣做某事|冇癮
沒興趣|心淡
沒良心|冇本心
沒花巧|沒花假
沒著落|吊吊揈
沒見|冇見
沒見到|唔見
沒見識|冇眼界
沒見過|冇人有
沒記性|冇耳性
沒話好說|冇嘢講
沒話說|唔話得
沒說|冇得彈
沒譜兒|冇譜
沒買賣|拋錨
沒趣|冇癮
沒轍兒|冇修
沒轍|冇計
沒辦法|冇計
沒道理|冇解
沒道理還硬辯|死硬撐
沒遮沒掩|冇遮冇掩
沒錢可賺|冇得撈
沒錯兒|冇錯
沒門兒|冇行
沒閑空兒|冇時
沒關係|冇所謂
沒鞋帶的鞋|懶佬鞋
沒頭沒腦|冇厘頭
沒頭沒腦地亂闖的人|失魂魚
沒頭蒼蠅|冇頭烏蠅
沒骨氣|冇料
沙丁魚|沙甸魚
沙包|搲子
沙啞|嗄
沙啞的嗓門|豆沙喉
沙嗓子|豆沙喉
沙拉|沙律
沙沙|時時沙沙
沙河粉|河粉
沙烏地阿拉伯|沙地阿拉伯
沙發|梳化
沙石灰塵|沙塵
沙茶醬|沙爹
沙辣子|沙律
沙鍋|瓦鐺
沙鍋豆腐|豆腐煲
沙鰨|鰨沙魚
河堤圍著的土地|基
河汊子|河涌
河流|河
河|海
河溝|河涌
河蟹|大閘蟹
河裏產|河
河豚|雞泡魚
河豚魚|雞泡魚
沸|滾
油乎乎|油淰淰
油嘴滑舌|賣口乖
油提子|油潞
油條|油炸鬼
油水|肥膩
油汪汪|油淰淰
油渣兒|油渣
油滋滋|油𥹉𥹉
油漆|漆油
油漬|肥油
油灰|桐油灰
油炸過的水麵筋|生筋
油炸食品|油器
油炸魚糜塊|魚腐
油煎餃子|煎餃
油燈|燈盞
油篩|㷹籬
油耗味|油䭞
油腔滑調|賣口乖
油膩|肥膩
油船|油躉
油角|角仔
油豆腐|豆卜
油鋪|雜貨鋪
油頭滑腦|鬼五馬六
油餅|咸煎餅
油香餅|鹹煎餅
治標不治本|斬腳趾避沙蟲
治標|止到咳
沾上水|濕水
沾上邊兒了|濕身
沾光|黐
沾水|掂水
沿江邊築的堤壩|基圩
沿著|沿住
沿街拉客的私娼|野雞
泄水管|水槽
泄漏|爆料
泄私忿|找晦氣
泄露秘密|爆煲
泄露|穿煲
泊船下錨|拋錨
泊船用具|錨
泔水|潲
泔腳|餿水
法子|諗頭
法師|茅山師傅
法幣|濕柴
法式吐司|西多士
法術|茅山法術
法鈴|鈴鈴
泡沫塑料|發泡膠
泡沫|泡泡
泡溫泉|浸溫泉
泡茶|沖茶
泡菜|霉菜
泡豆芽|漚芽菜
泡麵|即食麪
波士尼亞|波斯尼亞
波札那|博茨瓦納
波棱蓋兒|波羅蓋
泥人|泥公仔
泥子|桐油灰
泥水匠|泥水佬
泥水匠用的尺|師傅尺
泥沙|黃泥
泥濘|泥湴
泥牛入海|豬籠入水
泥狀餡類|茸
泥猴兒|邋遢貓
泥瓦匠|泥水佬
注入|斟
注定|整定
注射器的針尖|針嘴
注射器|針筒
注意到|有留意
注意地看|眈
注意|留意
注重打扮|姿整
洋人|老番
洋人軍官|鬼頭
洋娃娃|公仔
洋學生|番書仔
洋房子|洋樓
洋房|私家樓
洋文|雞腸
洋梨|啤梨
洋氣|僑
洋洋自得|白攉
洋灰|紅毛泥
洋白菜|椰菜
洋相|異相
洋芋片|薯片
洋芋|薯仔
洋芹菜|西芹
洋菜花|西蘭花
洋蠟|洋燭
洋車|車仔
洋鎬|啄
洋鬼子|鬼佬
洋鴨|番鴨
洗刷得|㨘到
洗得手都酸了|洗到手軟
洗手不幹|金盤洗手
洗澡房|泡水館
洗澡|沖涼
洗澡間|沖涼房
洗照片|矖相
洗熱水澡|沖熱水涼
洗相片|曬相
洗碗布|碗布
洗碟子|洗大餅
洗米水|米水
洗腸|洗肚
洗臉毛巾|面巾
洗臉盆|面盆
洗衣|洗衫
洗衣皂|番梘
洗衣粉|梘粉
洗衣裳|洗衫
洗頭髮|洗頭
洞穴|窟
洞穿|通窿
洞|窟窿
津津有味|滋滋味味
洩露大機密|爆大鑊
洩露秘密|爆料
活兒|世藝
活動一下|行下
活動插座|拖板
活動|郁動
活動金屬門|鐵閘
活受罪|陰功
活命|吊命
活埋|生壅
活廣告|生招牌
活得好好|生勾勾
活招牌|生招牌
活潑有趣|趣怪
活潑貌|跳跳貢
活潑起來|生蝦
活潑|跳跳紮
活生生|監生
活結|生綟
活著|活住
活蝦|生蝦
活見鬼|撞鬼
活該受罪|抵捱
活該|抵死
活躍|生猛
活閻王|惡爺
洽商|斟
洽談|斟
派出所|差館
派出|發散
派進|派入
派遣|派
派頭挺足|大牌
派頭|款頭
流個不停|嗲嗲渧
流口水|口水流
流年|時年
流氓氣|爛
流氓無賴|爛佬
流氓|爛仔
流氓阿飛|飛仔飛女
流浪|流離浪蕩
流淚|落淚
流行|興
流連|浮
流離失所|流離朗蕩
浪|姣
浪費|嘥
浮在水面|浮面
浮田|蕹菜塘
浮誇|白攉
浮誇輕佻|沙塵
浮躁|霞霧
浴室|沖涼房
海報|招紙
海椒|燈籠椒
海水|鹹水
海洛因|海洛英
海洛|白粉
海洛英|白粉
海濱|海皮
海灣|灣
海盜|海賊
海軍裝|水手裝
海邊|海傍
海邊的夜市|鬼市
海魚一種|紅衫
海魚|海水魚
海鱟|鱟魚
消化不良|濕滯
消化力|胃火
消受不了|受唔起
消夜|宵夜
消失|摺埋
消息|聲氣
消息靈通人士|消息人士
消暑|清暑
消氣|下啖氣
消滅|滅晒
消火栓|消防喉
消瘦|清減
消耗|除拆
消閑活動|世藝
消防員|救火員
消防水帶|消防喉轆
消防水管|消防喉
消防水龍|消防喉轆
消防水龍頭|消防喉
消防車|救火車
消除|弭除
消食|消滯
消食開胃|開胃消滯
涉及|撈埋
涉|徑
涎|潺
涮洗|盪
涮|焯
液化石油氣|煤氣
液化石油氣鋼瓶|煤氣罐
液體滲入|浸
涼|凍
涼到心底|透心涼
涼嗖嗖|涼浸浸
涼快|涼爽
涼拌雜菜|沙律
涼果一種|陳皮梅
涼果|口果
涼爽宜人|風涼水冷
涼爽|風涼水冷
涼絲絲|涼浸浸
涼薯|沙葛
涼颼颼|涼浸浸
淅瀝小雨|溦溦雨
淋巴腺腫|癆
淋浴噴頭|花灑
淋浴糟兒|企缸
淋浴間|沖涼房
淋濕|溚溼身
淋濕的人|濕水雞
淋|灒
淋病|白椰菜花
淋雨|溚雨
淘氣|曳
淘氣鬼|大帝
淘汰|否
淘米水|米水
淘米|洗米
淘|跳皮
淚水盈眶|一殼眼淚
淚水|眼水
淚汪汪|一殼眼淚
淚盈於睫|眼濕濕
淚眼模糊|一殼眼淚
淚眼汪汪|一殼眼淚
淡巴巴|淡謀謀
淡水小蛤蜊|蜆
淡水魚類|河鮮
淡|淡謀謀
淡而無味|清水白煠
淡菜|旺菜
淨|埋晒
淨意|特登
淨說不邊際的話|話三話四
淫婦|姣婆
淫混|雞蟲
淫穢下流|鹹
淫穢影片|鹹片
淫穢|鹹濕
淫蕩|姣
淫蕩的女人|姣婆
淬火|灒火
深仇大恨|十冤九仇
深入想想|諗深一層
深吸氣|嗍
深吸着氣聞|嗍
深呼吸|唞大氣
深夜|夜麻麻
深山中偏僻處|山旮旯
深思熟慮|想深一層
深藍色|海軍藍
混不下去|冇得撈
混亂|立雜
混入|浸
混凝土樓房|石屎樓
混凝土|石屎
混合|勼
混在|混埋
混得|撈得
混|撈
混日子|胡混
混水摸魚|搏亂
混混沌沌|懵盛盛
混混|飛仔
混蛋|躝癱
混血兒|雜種仔
混血|打亂種
混賬|譅戇
混身動|周身郁
混雜|雜崩冷
混飯吃|搵食
淹水|水浸
淹沒|浸死
淹|浸
淺幫|淺身
淺色醬油|白油
淺藍|湖水藍
淺顯|一字咁淺
添丁甜醋|甜醋
添亂|混吉
添加|加添
添麻煩|騷擾晒
清亮|爽
清光|清光
清剿|冚竇
清塘|刮塘
清掃工人|掃地
清早|朝早
清楚|明
清楚記得|很記得
清涼茶|涼茶
清淡|清
清清淡淡|清清哋
清漆|士力
清潔工|擸𢶍佬
清澈|清
清爽|涼浸浸
清理乾淨|清晒
清理|清
"清理"|清整
清秀漂亮|青靚
清賑|清數
清賬|清盤
清閑|乃乃閑
清閒|迆
清除|清走
清雅|清景
清靜|靜局
清鼻涕|鼻水
減價|減
減少|減
渠務工人|通渠佬
渠道|坑渠
渡輪|街渡
渣土|泥頭
測定重量|秤
測量|度
測量重量的器具|秤
測電螺絲刀|電筆
測驗卷|小測卷
港口|埠
港幣一千元|金牛
港幣一百元|紅三魚
港幣十元|青蟹
港幣|港紙
港澳|下便
港產電影|港產片
渴了|口渴
渴望|好欿
渴望發財|發錢寒
游手好閑|游游閑
游標|鼠標
游泳|泅水
游泳褲|泳褲
游玩|游河
游蕩不定居|流離浪蕩
游逛|行
渺茫|水汪
渾名|花名
渾小子|衰仔
渾渾噩噩|懵盛盛
渾身|周身
湊份子|佮份
湊合|求其
湊合用|頂檔
湊合著|求其
湊在一塊兒|埋堆
湊在一起|共埋
湊夠人手|湊腳
湊夠|湊埋
湊巧|蹺
湊熱鬧兒|戥興
湊熱鬧|趁高與
湊起來|湊埋
湊趣|贈興
湊足|湊夠
湊近去聞|哄
湊近|哄
湊過去|哄個頭埋去
湊齊人數|戥腳
湊齊|戥腳
湖藍|湖水藍
湯匙|匙羹
湯圓|湯丸
湯姆|阿湯哥
湯|湯水
湯粉|沙河粉
湯藥|茶
湯藥費|湯藥
湯鍋|湯煲
準保|包保
準備就緒|儲定彈藥
準備|諗住
準時|依時依候
準會|鬼唔望
準頭|眼界
準點兒|依時依候
溜之大吉|鬆人
溜冰鞋|雪屐
溜掉|走路
溜旱冰|踩雪屐
溜溝子|托大腳
溜|瀡
溜肩|美人肩
溜肩膀|美人肩
溜走|走路
溜鬚拍馬|擦鞋
溝渠|坑渠
溢出|瀉
溪錢蠟燭|元寶蠟燭
溫和|和暖
溫度表|溫度計
溫暖|暖衲衲
溫書|冞書
溫|温
溫順|馴品
溫飽|揾兩餐
溺水|浸死
滅他威風|㓢佢棚牙
滋|滋
滋味|味
滋味鮮美|清甜
滋補身體|補身
滑動|瀡
滑扣|滑牙
滑旱冰|滾軸溜冰
滑溜溜|滑漦漦
滑溜|滑腍
滑滑|滑嘟嘟
滑潤|油潤
滑稽|攪笑
滑而多油|滑揗揗
滑而帶粘液|滑潺潺
滑落|甩
滑|跣
滑頭|鬼馬
滔滔不絕|一輪嘴
滯銷|唔好市
滯銷貨|濕柴
滲井|沙井
滲合|撈
滲坑|沙井
滴個不停|嗲嗲渧
滴|涿
滴溜圓|圓碌碌
滴答水|水渧渧
滴裏耷|丁零襶褦
滷味|滷水
滾動|轆
滾燙|滾熱辣
滾珠|波珠
滾蛋|躝屍趌路
滾|躝屍
滾軸溜冰|踩雪屐
滾開！|躝開！
滿佈皺紋|打晒摺
滿員|爆滿
滿嘴粗話|媽媽聲
滿|夠
滿屋|通屋
滿座兒|爆滿
滿座|爆棚
滿意|夠味
滿把辛酸淚|一殼眼淚
滿滿|密窒窒
滿能|幾
滿臉羞慚|一面屁
滿臉通紅的人|紅面關公
滿臉通紅|面紅紅
滿臉陰雲|黑口黑面
滿街|周街
滿貫|爆棚
滿足|夠本
滿身麻煩|一身蟻
漂亮好看|靚
漂亮小伙子|靚仔
漂亮的|㜺
漂亮的女警察|警花
漂亮的姑娘|靚女
漂亮的小伙子|靚仔
漂亮英俊的男孩|靚仔
漂亮|靚
漂洗|過
漂浮|浮
漆得|油
漆|油
漉漉|納納
漏了單|走單
漏勺|疏殼
漏尿|攋尿
漏水|滴水
漏洞|漏罅
漏縫兒|漏罅
漏風|漏口風
演出傳統戲劇|做大戲
演出說明書|戲橋
演出|騷
演員表|卡士
演奏|拉
演戲|做戲
演戲的場所|戲院
演練武術|打工夫
演雙簧|扯貓尾
漚|罨
漢堡|漢堡包
漩渦|轉
漫不經心|唔嗲唔吊
漫天要價|開天索價
漱口|啷口
漱口杯|口盅
漲價|起價
漲租金|起租
漸層|漸變色
漿子|漿糊
潑婦|嗌街婆
潑辣刁蠻|傖雞
潑辣|吧喳
潑辣女人|霸王花
潔白|白雪雪
潛下|沒落
潛水員|蛙人
潛水|沒水
潛|氼
潛逃|着草
潤滑油|機油
潤滑脂|雪油
潦草|烏喱馬扠
潮水退盡|水乾
潮濕氣|水氣
潮濕|溼𣲷𣲷
潲水|米水
潲|潎
潲雨|撇雨
潷|泌
澆水桶|飲桶
澆|淋
澆濕了頭|照頭淋
澥黃兒|涴蛋
澱粉|豆粉
激動|肉緊
激怒|吹
激靈|打冷震
濃密|蘙
濃湯|羹
濃稠|傑
濕氣|水氣
濕淋淋|落雨絲濕
濕|溼
濕漉漉|溼𣲷𣲷
濕灰|煙屎
濛濛細雨|雨粉粉
濺|𤁢
濾去|隔
濾清|滰清
濾|潷
濾盆|筲箕
瀉肚|肚屙
瀏海|陰
瀏覽|擸
瀝乾|滰乾
瀝水籃|筲箕
瀝青|蠟青
瀰因|迷因
灌水|入水
灌迷湯|拋生藕
灌酒用的漏|酒漏
灌醉|懟冧
灌開水|沖滾水
灑|倒瀉
灑出|瀉
火候不夠|唔夠火
火候恰當|鑊氣
火候|火路
火兒了|火起
火兒|火起
火冒三丈|眼火爆
火卡車|卡
火喉|火路
火夫|伙頭
火屑|火屎
火彤彤|紅噹噹
火性子|炮仗頸
火星兒|火屎
火星塞|火嘴
火星子|火屎
火氣冒上來|扯火
火氣|熱氣
火油|火水
火灼|煪
火災|火燭
火熱|焮
火燒眉毛|火燒眼眉
火燒眼眉|水浸眼眉
火燒雲|紅雲
火燭|火災
火爆脾氣|炮仗頸
火蝸牛|東風螺
火表|電表
火警|火燭
火車車廂|卡
火鍋用的鍋|邊爐鍋
灰塵|泥塵
灰心喪氣|心灰
灰心失望|心淡
灰心|心灰
灰溜溜|死死氣
灶底下|灶底
災星|災瘟
災禍|冬瓜豆腐
炊事員|伙頭
炊具|煮飯仔
炎熱天氣下|大熱天時
炎熱|很熱
炒好|兜勻
炒得香|夠鑊氣
炒股票|炒股
炒菜用的鏟子|鑊鏟
炒菜鍋|鑊
炒賣股票|炒股
炒賣風氣|炒風
炒賣黃金|炒金
炒鍋|鑊
炒魷魚|輯包袱
炕桌兒|炕几
炕桌|炕几
炫目|劖眼
炫耀自己|晒命
炫耀身世|曬命
炭爐|風爐
炮仗|炮竹
炸土豆條兒|薯條
炸山|爆山
炸蝦片|威化
炸豆腐乾|豆泡
炸開|爆開
炸香|爆香
為了什麼|為乜嘢
為了|貪
為人|人品
為人好|好人事
為人幫忙|做臺腳
為人老實可靠|擔屎都唔偷食
為什麼|點解
為何|緣何
為別人服務|為得人
為別人高興|贈興
為屋頂補漏|執漏
為我著想|想我好
為朋友著想|為得朋友
為正義不怕死|膽正命平
為爐灶生火|透爐
為自己打如意算盤|諗縮數
為自己打算|諗縮數
為難|難為
為首|行頭
烈|勍
烈酒|燒酒
烏七八糟|鬼五馬六
烏欖|欖角
烏溜溜|烏黢黢
烏芋|馬蹄
烏賊|墨魚
烏雞|竹絲雞
烏面貓|黑面貓
烏魚|生魚
烏鱧|生魚
烏龍麵|烏冬
烏龜|龜
烘好|出爐
烘|炕
烘烤|焗
烙鐵|焫雞
烙餅|薄鐺
烤乾|收水
烤制肉食的總稱|燒臘
烤東西吃|燒烤
烤漆|焗漆
烤火|焙火爐
烤|燒
烤爐|焗爐
烤箱|焗爐
烤肉串兒|串燒
烤肉|叉燒
烤肉條|叉燒
烤豬切出來的肉|燒肉
烤豬肉|燒豬肉
烤餅|焗餅
烤鴨|片皮鴨
烤麵包片|多士
烹製素菜餚食物|齋菜
烹調方法|煮法
烹調菜肴|煮菜
烹飪法之一|燴
焊接|啤
焗暑|焗親
焞|熰
無一點新意|返炒牛肉
無中生有|冇端生有
無事可做|空手掉空臂
無人要之物|爛茶渣
無內容|乾
無|冇
無利可圖的事|豬頭骨
無口才|口拙
無可奈何|冇奈何
無可指摘|冇得彈
無可挑剔|冇得駁
無可挽救了|蛇都死
無可挽救|死直
無可救藥|冇得摱
無可置疑|直程
無可避免|避冇可避
無地自容|一面屁
無奈何|冇奈何
無尖端|屈頭
無從解釋|冇解
無怪乎|唔怪得
無情義|反骨
無意之中|唔在意
無懈可擊|冇得彈
無所不在|冇所不在
無所不知的人|通天曉
無所事事|游離浪蕩
無所收獲|冇聲氣
無所畏懼|冇有怕
無所謂|唔拘
無拘無束|冇拘冇管
無數|冇千冇萬
無明火起|一把火
無本事|水
無棱絲瓜|水瓜
無法區分|唔識分
無法忍受|唔忍到
無法收回|爛
無法收場|攪到唔湯唔水
無法收拾|唔得掂
無法溝通|雞同鴨講
無犯罪記錄證明書|良民證
無用之材|爛泥扶唔上壁
無用|唔等使
無用的人|紙紮公仔
無病無災|冇穿冇爛
無益|唔等使
無立錐之地|冇瓦遮頭
無端|冇端端
無籽|冇核
無精打采|冇厘神氣
無糖|走糖
無線電喇叭|大聲公
無緣無故|冇端端
無繫帶的鞋|懶佬鞋
無聊|冇癮
無聊賴|冇細藝
無能|廢
無與倫比|冇得頂
無著落|半天吊
無計劃|離咁氣
無計可施|冇符
無話可說|冇得傾
無論什麼時候|幾時
無論|唔理
無論如何都|幾大都
無論如何|點講
無論怎麼忙|幾忙
無論變成甚麼|做鬼做馬
無謂的爭執|口同鼻詏
無謂的頂牛|口同鼻詏
無賴漢|爛仔
無賴|爛仔
無足輕重的人|茄哩啡
無錢|使鬼唔靈
無關|唔關
無關緊要|唔等使
無阻塞|通籠
焦急|心急
焦頭爛額|頭崩額裂
然後|跟住
煉乳|淡奶
煉好的熟豬油|豬膏
煉好的豬脂肪|豬油
煎中藥用的沙鍋|藥煲
煎雞蛋|奄列
煙囟|煙通
煙捲兒|煙仔
煙渣|煙屎
煙漬|煙屎
煙火|煙花
煙灰缸|煙灰盅
煙|煙仔
煙熏|煪
煙草|煙
煙鬼|煙鏟
煞尾|埋尾
煞有介事|係威係勢
煞車|煞制
煤末兒|媒粉
煤末|煤粉
煤氣眼|煤氣口
煤油|火水
煤油爐兒|火水爐
煤渣|煤屎
煤灰|煤屎
煤鏟|煤灰鏟
照他的樣子做|睇住佢頭
照例|例牌
照做不誤|照殺
照|影
照應|關照
照料家務|睇頭睇尾
照料|湊
照樣兒|仲係
照樣兒學|有樣學樣
照樣再來一次|照辦煮碗
照樣大吃|照津
照樣|照
照樣畫葫蘆|有樣學樣
照正理說|計正
照片|相片
照理說|照計
照相樓|影樓
照相簿|相簿
照着字帖習字|臨帖
照着樣子做|照板煮碗
照著|照住
照說|照計
照顧家庭|顧家
照顧|照住
煩勞|勞煩
煩悶|翳悶
煩惱|頭痛
煩死了|煩到死
煩燥|忟憎
煩躁|心火盛
煮得很軟的飯|爛飯
煮得爛熟|腍
煮水壺|水煲
煮|煲
煮熟|滾熟
煮熟的狗頭|熠熟狗頭
煮爛|煲腍
煮稀飯|煲粥
煮開水|煲茶
煮飯用大鐵鍋|飯鑊
煮飯的鍋|飯煲
熄滅|死火
熄火|死火
熊|熊人
熏製|煙
熒光燈|光管
熒光燈啟輝器|士撻
熗嗓子|涸喉
熗鍋|起鑊
熙熙攘攘|人頭涌涌
熟悉|熟落
熟成|軟身
熟抽|豉油
熟稔|熟絡
熟米粉條|沙河粉
熟練|熟落
熟肉|斬料
熟讀|刨熟
熟食再加熱|燂
熨斗|燙斗
熬中草藥|煲藥
熬壞|挨壞
熬夜唸書|棟高牀板
熬夜|捱夜
熬日子|挨世界
熬湯的基本原料|湯底
熬|煲
熱傷風|焗傷風
熱呼呼|熱辣辣
熱哄哄|熱辣辣
熱天|天時熱
熱水器|熱水爐
熱水壺|水煲
熱水瓶|暖水壺
熱水袋|暖水袋
熱湯|滾湯
熱烈|七彩
熱烘烘|焮烚烚
熱熱鬧鬧|柴哇哇
熱狗|腸仔
熱衷|恨
熱衷於|大癮
熱鍋|猛鑊
熱門|大熱
熱騰騰|熱辣辣
熱鬧|旺場
熱鬧點|旺區
熾熱|很熱
燈油錢|燈油火蠟
燈泡兒|燈膽
燈泡|燈膽
燈管|光管
燉煮的補品|炖品
燒剩下的渣|屎
燒壞|燒壞腦
燒壞的瓦不平整|燒壞瓦
燒柴的爐子|風爐
燒水壺|水煲
燒炭的小泥爐|風爐
燒烤活動|燒烤會
燒烤火爐|爐
燒烤醃臘熟食|燒臘
燒烤食品的總稱|燒味
燒焦|煲燶
燒煤剩下的杰|煤灰
燒煤油的照明燈|煤氣燈
燒煤的爐子|煤爐
燒|煮
燒熱|焫焮
燒紙錢|燒衣
燒臘|燒味
燒蠟|煲蠟
燒蠟燭|煲蠟
燒衣紙|燒衣
燒豬肉中的骨頭|燒骨
燒酒|雙蒸
燒開水|煲水
燒飯|煮食
燒香|裝香
燒鴉片煙泡|打河
燙傷|淥親
燙髮|電髮
燜|炆
營利|牟利
營帳|營幕
燥熱|熱氣
燭臺|手照
爆冷門|爆冷
爆皮|爆坼
爆竹|炮仗
爆竹的火藥線|炮仗引
爆米花|爆穀
爆胎|爆呔
爐子|風爐
爛人|衰人
爛泥塗不上牆|爛泥扶唔上壁
爛泥|泥湴
爛|涴
爛熟|腍
爛糟糟|爛苴苴
爪牙|馬仔
爬上爬下|擒高擒低
爬來爬去|躝嚟躝去
爬坡|上斜
爬山|行山
爬行|躝
爭位子站|爭位企
爭勝負|賭
爭口氣|爭番啖氣
爭吵|鬧交
爭執|拗數
爭奪家產|搶財產
爭奪|爭
爭奪男朋友|爭仔
爭得死去活來|爭生爭死
爭氣|生性
爭|詏
爭論|拗數
爭辯不休|牙譫譫
爭辯|詏頸
爭鬥糾纏|死纏爛打
父子|仔爺
父子倆|兩仔爺
父子兩|兩仔爺
父母與子女|親子
父親的舅母|大妗婆
爸媽|父母
爸爸|阿爸
爹媽|老豆老母
爺兒倆|兩仔爺
爺孫兩|兩爺孫
爺爺和孫子|爺孫
爺爺|阿爺
爽利|爽手
爽快感覺|爽快感
爽快|爽手
爽朗|心爽
爽約|甩底
爽脆|彈牙感
牆倒眾人推|一沉百踩
牆壁|樓身
牆皮|批盪
牆裏開花牆外香|本地薑唔辣
牆頭草|鬼頭仔
片子|片
片|幅
片狀的紅糖|片糖
版主|谷主
牌九|天九
牌位|神位
牌兒|籌
牌匾|招牌
牌友|雀友
牌子|牌號
牌照|拉臣
牙垢|牙積
牙床|牙骹
牙床骨|牙骹
牙根發軟|牙軟
牙縫兒|牙罅
牙花子|牙肉
牙都笑掉了|笑甩棚牙
牙齦|牙肉
牚牙牚齒|牚牙骹
牛勁兒|牛力
牛嘴罩|牛笠
牛圈|牛欄
牛外脊|牛柳
牛心柿|水柿
牛排|牛扒
牛油多士|油多
牛犢兒|牛仔
牛犢子|牛仔
牛的蜂巢胃|牛百葉
牛皮氣|牛精
牛皮紙|紙皮
牛筋|牛板筋
牛肉腸粉|牛腸
牛肋骨下的肉|坑腩
牛肚|牛百葉
牛胰臟|牛膀
牛脾氣|牛頸
牛腰部的囊肉|牛腩
牛腱子|牛腱
牛虻|牛蠅
牛裏脊|牛柳
牛裏脊肉|牛柳
牛蹄筋|牛孖筋
牛軋糖|紐結糖
牛頭褲|牛記
牛高馬大|大隻騾騾
牡犡乾|蚝豉
牡蠣|蠔
牢固|實淨
牢|監
牢記|記緊
牢靠|穩陣
牢騷|嘮嘈
牧牛|看牛
物以稀為貴|物以罕為貴
物件|淋瀋
物品堆積貌|堆堆疊疊
物品殘餘的部分|頭
物品|物件
物品的個數|個頭
物品的殘餘部分|頭
物很薄|薄切切
物樣品|貨辦
物色影視演員的人|星探
物量減少|縮水
物體內部的支架|骨
物體透明的程度|透明度
牲口|頭牲
牲畜|畜牲
特價|超筍價
特別便宜的價格|超筍價
特別便宜的價錢|跳樓價
特別新奇|新樣
特別瘦弱|奀雌雌
特別|認真
特地|特登
特大份量|加大碼
特定的時間|鐘數
特意|特登
特棒|夠勁
特殊|特意
特殊的愛好|嗜好
特殊的記號|識認
特特兒|特登
特登|一登
特色的菜式|招牌菜
牽冠軍馬匹|拉頭馬
牽|拖
牽掛|掛住
牽累|佗衰
牽線|撦綫
牽線木偶|扯線公仔
牽頭|扯頭纜
犁田|駛田
犄角兒|角落頭
犄角旮旯|窿窿罅罅
犧牲品|炮灰
犬字旁|戾狗邊
犬猶兒|狗爪邊
犬部|狗爪邊
犯傻|霎戇
犯案|做世界
犯眾怒|犯眾憎
犯糊塗|霎戇
犯罪活動的統稱|偷呃拐騙
犯罪記錄|案底
犯規|否
犯錯誤|行差踏錯
犯風化案的男子|色魔
狂妄|牙擦
狂|撚
狂暴的色鬼|色狼
狂笑|劇笑
狐朋狗友|豬朋狗友
狐臭|臭狐
狗叫聲|噢
狗咬狗|狗咬狗骨
狗急跳墻|事緊馬行田
狗爪旁|狗爪邊
狗牙形|狗牙
狗|狗隻
狗窩|狗竇
狗肉|香肉
狗腿子|馬仔
狗血噴頭|狗血淋頭
狗血淋頭|一面屁
狗頭軍師|敗水軍師
狠命地毆打|做世界
狠命|狼胎
狠射|勁射
狠揍|做世界
狠毒|狼毒
狠狠地揍|拍薑噉拍
狠|狼戾
狡猾|古惑
狡詐|詭譎
狡黠|詭蜮
狹小|局
狹小的居屋|白鴿籠
狹窄的巷子|橫街窄巷
狹窄通道|冷巷
狹窄|逼
狼吞虎咽|淋擒
狼命|狼胎
狼狽不堪|倒瀉籮蟹
狼狽|離咁氣
猛|拫
猛烈批評|狂踩
猛烈|猛
猛然拉動|擢
猛然用力擺動|戳
猛開快車|飛車
猜|估
猜想|估
猜拳|包剪搥
猜拳用語|開晒
猜測|估下
猜球|估波膽
猜疑|思疑
猥瑣的男人|鹹濕佬
猥褻的男人|咸濕公
猥褻|非禮
猩猩木|聖誕花
猴三兒|馬騮
猴兒|馬騮
猴子|馬騮
猴皮筋|橡筋箍
猶豫不定|心大心細
猶豫不決|心大心細
獅子山|塞拉利昂
獅子狗|鬆毛狗
獎賞|打賞
獎金|花紅
獐頭鼠目|蛇頭鼠眼
獨一無二|絕冇二樣
獨個兒|單丁
獨吞|落格
獨家生意|獨市生意
獨家買賣|獨市生意
獨斷獨行|自把自為
獨生子|香爐墩
獨眼|單眼
獨眼者|獨眼龍
獨眼龍|單眼仔
獨自一人|一枝公
獨自|單丁
獨自飲酒|自斟自飲
獮猴桃|奇偉果
獲勝|勝出
獲得|攎到
獲得財物|代代平安
獲派|派入
獼猴桃|奇異果
率直|直腸直肚
玉石俱焚|攬炒
玉米|粟米
玉米花兒|爆穀
玉蜀黍|粟米
王八|水魚
王八蛋|龜蛋
玩一下|玩番
玩了以後|玩落
玩個夠|玩餐飽
玩個痛快|痛玩一番
玩偶|公仔
玩兒命|搏命
玩兒完|玩完
玩兒把戲|出把戲
玩兒|玩
玩具娃娃|公仔
玩具炊具|煮飯仔
玩具|醉酒公仔
玩單杠|打杠架
玩夠了|玩飽
玩夠|玩足
玩好一陣子|有排玩
玩妓女|嫖
玩完|收檔
玩家|玩家
玩弄|整古
玩戲法|出把戲
玩|撚
玩撲克牌|玩啤牌
玩樂熱點|蒲點
玩樂者|蒲友
玩樂|蒲
玩熟了|玩上手
玩耍|耍樂
玩花招|出術
玩花燈|玩燈籠
玩遊戲|打機
玩遊戲機|打機
玩電子游戲機|打游戲機
玫瑰紅色|玫紅
玻璃牆壁|玻璃幕牆
玻璃珠兒|玻珠
玻璃珠子|玻珠
玻璃球|波子
玻里尼西亞|玻利尼西亞
珍愛|寶貝
珍珠粉|珠末
珍視|寶貝
珍貴|矜貴
珓杯|杯
珠江邊|海皮
班配|襯到絕
班鱧|生魚
現下|而家
現世報應|現眼報
現世報|現眼報
現世|獻世
現世現報|現眼報
現今|今下
現在|而今
現在說起來|家陣嚟講
現場|當場
現成|便
現暫不討論|姑勿論
現燒火現砍柴|臨急開坑
現狀|現況
現眼|獻世
現編|爆肚
現而今|而家
現金|現銀
球|波
球生圈|水泡
球莖甘藍|芥藍頭
球藝很差|屎波
球衣|波恤
球賽的票|波飛
球賽裁判|球証
球門|龍門
球隊隊員|球員
球類運動員|球手
球類運動裁判員|球證
理想|掂
理所當然|自不然
理會|睬
理由|因由
理睬|睬
理解錯誤|擺烏龍
理|飛
理髮工具之一|推剪
理髮師|飛髮佬
理髮店|飛髮鋪
琉璃製小玩藝|琉璃獸
琢磨|度
瑣瑣碎碎|淋淋瀋瀋
瑣碎|𦠿碎
環食|環蝕
瓊脂|大菜膏
瓜地馬拉|危地馬拉
瓜子兒臉|瓜子口面
瓜子臉形|瓜子口面
瓜果的蒂|椗
瓜菜棧|菜欄
瓢|殼
瓣兒|楷
瓣|楷
瓦匠|泥水佬
瓦圈|框
瓦壟|瓦坑
瓦壟的凹槽|瓦坑
瓦工|泥水佬
瓦斯桶|石油氣罐
瓦楞紙|瓦通紙
瓦溝|瓦坑
瓦特|火
瓦盆的一種|沙盆
瓦盆|砂盆
瓦缸子|瓮缸
瓦罐|罌
瓦質鍋|鐺
瓶兒|樽
瓶塞兒|厔
瓶塞|樽枳
瓶子|樽
瓶|樽
甘心|心甘
甘比亞|岡比亞
甘蔗|蔗
甘薯塊煮糖水|番薯糖
甘薯|檳榔薯
甘薯象鼻蟲|沙虱
甘藍菜|芥蘭
甚至於|甚至無
甚至|甚至冇
甚麼|乜
甚麼來頭|乜水
甚麼好價錢|咩靚價
甚麼東西|乜東東
甚麼辦法也不行啦|蛇都死
甚麼辦法也沒有|乜都假
甜品的總稱|糖水
甜品|糖水
甜奶酪|雙皮奶
甜得發膩|甜嘢嘢
甜橙的一種|柳橙
甜津津|甜嘢嘢
甜湯|糖水
甜甜圈|冬甩
甜的發膩|甜椰椰
甜絲絲兒|甜淰淰
甜絲絲|甜嘢嘢
甜而膩|甜嘢嘢
甜膩膩|甜嘢嘢
甜言蜜語|口甜舌滑
生不舒服|唔精神
生事|搞事
生來沒錢|五行缺水
生個孩子沒屁眼兒|生仔冇屎忽
生動|生鬼
生小孩|生仔
生怕|慌死
生悶氣|局氣
生意不好|淡市
生意人|生意佬
生意做不成|冇交易
生意做得成|有交易
生意冷淡|拍烏蠅
生意好|旺市
生意|市
生意清淡|曬蓆
生意興隆|好景
生手|初哥
生抽|抽油
生日|牛一
生日的女孩|壽星女
生日聚會|生日會
生橄欖|白欖
生氣上火|心火盛
生氣勃勃|龍精虎猛
生氣|勞氣
生活不好|唔好世界
生活|世界
生活好|好景
生活維持不下去|攪唔掂
生活舒適自在|他條
生火|透火
生爐子|起爐
生產|整
生疏|丟疏
生病|打敗仗
生的蜂巢胃|牛百葉
生|臊
生葬|生壅
生薑|薑
生蠔|鮮蠔
生辰八字|時辰八字
生長出|起
生長|長
生魚片|魚生
生龍活虎|龍精虎猛
產婦開始陣痛|作動
產業|物業
產|産
用一用|使使
用不著|唔使
用不著奇怪|唔怪得
用不長久|唔禁
用低速檔|低波
用來|用嚟
用做|做
用具|架撐
用冰凍|雪
用刀削|劘
用剪刀|偷
用力塗抹|幯
用力抽打|鞭
用力搖動|戳
用力擦拭|幯
用力猛放|扽
用力睜大|睩
用力砍殺|抨
用力|重手
用功|勤力
用功讀書的人|冞家
用小刀等刻|劘
用小沙鍋煮的飯|煲仔飯
用尺比着畫線|間
用心專注|用神
用心|畀心機
用心盯住|足晒用神
用情不專|花心蘿蔔
用戶|用家
用手掌掬|兜
用手揉|搋
用手碰|玷手
用手背或板子打|撻
用指甲按|掐
用指甲掐|劘
用指甲擠死|釘
用於事項|點
用於瓶狀物|樽
用於穗類|穗
用杯珓卜吉凶|勝杯
用棍打|捗
用槍自殺|吞槍
用模子鑄|倒模
用氈做|氈
用沙鍋燒煮|煲
用液體燙|熝
用清水煮|煠
用炭火燒烤|明爐
用熱油略炒|爆
用猛火煮成|明火
用甑蒸酒|甑酒
用竹白織的席|軟笪
用筆加上點子|點
用篦子梳|篦
用細棍子打|箾
用繩子攏住|繣
用繩拉拽|絞
用罩子蓋住|罩
用肩挑|擔
用腦力|食腦
用腦袋去想|食腦
用萬維網|上網
用角頂|用角𤙴
用計謀施以打擊|煲
用詭計|出術
用酒浸製|醉
用醬腌製|醬
用鉗子夾物|鉗
用鋤頭勞作|鋤
用鋸拉|鋸
用錢|使錢
用鎖把門等關住|鎖
用鏟或鍬或清除|鏟
用雙線間隔成的行|雙行
用電話談話|講電話
用鼻子聞|嗅
甩動|揈
甩手兒|劈炮
甩掉|撇甩
甩|揈
甩綫步|甩綫
甩胳膊|掉臂
甭|唔使
甭客氣|唔使唔該
甭想|咪拘
甭指望|唔使恨
甭用|唔使
田埂|基
田壟|壢
田梗|田基
田裏的水道|竇
田間的小水閘|竇
田雞的大腿肉|蒜子肉
由不得|唔到
由大變小|縮
由於|事關
由著|隨得
由貌看出|有相睇
由長變短|縮
由|隨
甲基紫溶液|藍藥水
甲殼蟲樂隊|披頭士
甲狀腺腫大|大頸泡
甲魚|水魚
男丁的房子|丁屋
男仕西裝|三件頭
男伶|老倌
男儐相|兄弟
男士|男仔
男女流氓|飛仔飛女
男女間性行為|性事
男女鬼混|咿邑
男妓|契弟
男媒人|媒人公
男嬰|孲仔
男子漢大丈夫|男人佬耇
男子|男仔
男子留分頭髮式|留西裝
男子的鬢腳|滴水
男子髮式|陸軍裝
男孩兒|男仔
男孩子|男仔
男孩|男仔
男學生|學生哥
男廁所|男界
男性同性戀者|基佬
男性戲曲演員|戲子佬
男性生殖器官|子孫根
男性生殖器|是非根
男性留分頭|梳西裝
男性缺男子氣|陰氣
男性西洋人|番鬼佬
男戲子|老倌
男朋友|男友
男演員|男優
男生|男仔
男用|男界
男|男丁
男陰|鳩
男青少年|男仔
男青年|男仔頭
界石|界
界綫|界
界限|界
畏寒|發冷
畏縮|葸縮
畏首畏尾|躓手躓腳
留下案底|留案底
留下犯罪紀錄|留案底
留下|留低
留下話|話落
留心|覺意
留意|睺實
留校|留堂
留班|重讀
留着|留返
留神|打醒精神
留級|重讀
留辮子|梳辮
留|長
留院|留醫
畚箕|擸𢶍鏟
畢業典禮|畢業禮
畢業證或學位證書|紗紙
畢業證書|沙紙
畢業|讀完書
略修剪|捎
略微|略略
略濕於水|飲
略炸一下|拉油
略煮開|熝
略燒一下|燂
略燙|滾
略腌|剌
畦|壢
番木瓜的舊稱|萬壽果
番石榴的別名|雞屎果
番鬼荔枝|番荔枝
畫圖|畫則
畫家|公仔佬
畫著|畫住
異想天開|妙想天開
當下|家下
當主力|頂硬檔
當主要角色|頂硬檔
當主角|擔正
當今|而今
當保姆|住家工
當冤大頭|揾老親
當初|最初
當地惡霸|地膽
當場|當堂
當天晚上|即晚
當好人|做好人
當妓女|做雞
當官兒|官
當定|做硬
當廚子|做廚
當心"|好聲
當心性命|顧命
當心|顧住
當明星以後的運氣|星運
當時|個陣
當水手|行船
當然是|梗係
當然有|有定
當然|硬係
當牛做馬|捱騾仔
當物倉庫|當樓
當王八|戴綠帽
當班|開工
當着眾人|明火
當着矮子別說短話|崩口人忌崩口碗
當舖|大押
當賊|做賊
當鋪|大押
當面證明|頂證
當頭兒|做主
當頭棒喝|鬧醒
疊|沓
疊紙|摺紙
疊羅漢的俗稱|罧人山
疊被子|摺被
疏放豪爽|疏爽
疏疏|疏罅
疏|疏罅
疏落|離行離罅
疏通溝渠|通渠
疏遠|丟疏
疑惑|思疑
疑犯|疑匪
疙瘩|癩
疝氣|小腸氣
疣吻沙蚕|禾蟲
疥瘡|癩瘡
疲乏|癐
疲倦不堪|癐賴賴
疲倦|癐
疲勞|頹
疲累|攰
疲軟無力|軟躂躂
疳積病|生積
疳積|癪
疼愛|惜晒
疼痛|刺
疼|痛惜
痂|焦
病了|唔精神
病人制服|病人衫
病人|好人有限
病假單|醫生紙
病假證明|醫生紙
病包兒|病貓
病弱|孱
病得嚴重|五顏六色
病態慵懶的人|病貓
病號服|病人衫
病象|氣
痊癒|好清
痛心|激心
痛快|爽
痛打|做低
痛批|苛罵
痛擊頭部|扑頭
痛柄|痛腳
痛處|痛腳
痞子|爛佬
痠痛|㾓痛
痣|癦
痰桶|痰罐
痰涌上來|痰上頸
痰盂兒|痰罐
痰盂|痰罐
痱子|熱痱
痲疹|痲痘
瘀傷|瘀
瘀血|瘀
瘋了|燒壞腦
瘋女人|癲婆
瘋子|癲佬
瘋狂一晚|癲番晚
瘋狂地毆打|狂毆
瘋狂地玩樂一夜|癲番晚
瘋狂愛好者|發燒友
瘋狂採購|掃貨
瘋狂|癲
瘋狂購物|掃貨
瘋瘋癲癲|癲癲廢廢
瘋|癲
瘟神|災瘟
瘦了|清減
瘦子|吊門桔
瘦小|奀
瘦小孱弱|奀雌雌
瘦小的人|阿奀
瘦弱|奀
瘦得全變了樣|落晒形
瘦死的駱駝比馬大|爛船都仲有三斤釘
瘦猴兒|吊門桔
瘦瘦小小|奀镽镽
瘦瘦|瘦蜢蜢
瘦瘦長長|嫋嫋瘦瘦
瘦皮𤠣|馬騮乾
瘦而結實的人|鋼筋
瘦長的腿|香笄腳
瘦長|镽瘦
瘧疾|發冷
瘸子|阿跛
瘸|跛腳
療傷|養傷
療饑|醫肚
癌症|癌病
癖好極深|爛
癖好深|大癮
癟子|花生腳
癟穀|盼
癢|痕
癢癢|肉酸
癩狗扶不上牆|爛泥扶唔上壁
癩皮|生疵
癮君子|道友
癮頭兒大|爛癮
癮頭大|爛癮
癱瘓|癱
癲癇發作|發羊吊
癲癇|羊吊
登在報上|賣報紙
登基|登位
登山|行山
登工|一登
登廣告|賣告白
登記|札
登載|賣
登高|行山
發乾|涸涸哋
發了薪水|出咗糧
發亮|生輝
發佈|賣
發作|鬧
發冷|擔雞
發出|放
發動|撻
發夢話|發開口夢
發大財|發達
發奮圖強|扚起心肝
發奮|扚起心肝
發展|拓展
發工資|出糧
發布|發佈
發怒|發爛渣
發情|發姣
發愁|翳氣
發愣|木獨
發抖|忳忳震
發抖貌|震忳忳
發揮不了|揮不到
發春|發姣
發暮|年晚
發條|鏈
發楞|定晒形
發毛|發矛
發汗|焗汗
發泡塑料|發泡膠
發泡塑料盒兒|發泡膠盒
發|派
發火|撦火
發炎|眼熱
發熱|身熱
發燒|身熱
發牢騷|嘮嘈
發狂|發媌
發玩兒|爛玩
發球|開波
發生|起
發生關係|作怪
發病|起病
發瘋|發癲
發瘧子|發冷
發瘧疾|發冷
發癢|痕
發給|派
發羊癇|發羊吊
發羊角風|發羊吊
發脾氣|發狼戾
發芽|䅺芽
發薪|出糧
發薪水|出糧
發財|發達
發財致富|發達
發起|扯頭纜
發跡|撈起
發送|寄個
發酒瘋兒|發酒癲
發酵粉劑|泡打粉
發霉|發毛
發霉的氣味|霉霉臭臭
發音不對|唔啱音
發音|咬字
發音正確|啱音
白做的人情|水鬼人情
白吃公家飯|食阿爺飯
白吃飯|食塞米
白天上班|日更
白天|日頭
白契|空頭白契
白宮|華府
白幹|賺攪
白忙活|混吉
白手起家|白手興家
白斑病|白蝕
白木耳|雪耳
白油|生抽
白淨淨|白雪雪
白狗吃肉黑狗當災|黑狗得食白狗當災
白玉蘭|白蘭
白班|日更
白痴|痴綫
白癜瘋|白蝕
白癜風|白蝕
白癲風|白蝕
白白胖胖|肥肥白白
白白|賺
白皙|白淨
白皚皚|白雪雪
白看戲|睇霸王戲
白眼|打雀噉眼
白糖腌製的食品|糖果
白紙本子|拍紙簿
白腩|牛白腩
白色有翅母蟻|飛翼
白茫茫|白濛濛
白菜|白菜仔
白薯|番薯
白蘭地|拔蘭地
白豇豆|眉豆
白費力氣|嘥氣
白費|嘥
白費心思|白費心機
白走一趟|白行一趟
白酒|燒酒
白醬油|生抽
白面兒|白粉
白領階層|白領友
白麵包|方包
百元|張
百分之一|一個巴仙
百分之百|十足十
百分比|巴仙
百匯|布菲
百吃不厭|食過返尋味
百年之後|百年歸老
百無聊賴|冇聊冇賴
百貨商店|百貨公司
百足|雞蟲
的個人|嘅
的內臟|扶翅
的名字|個名
的。|咋。
的？|咋？
的|嘅
的手|隻手
的時候|嗰陣
的樣子|個樣
的機器|部機
的確是|確係
的確|的確
的要命|到飛起
的要死|到飛起
的話|得
的這|
的那|
皇后|天后
皇帝不急、急死太監|皇帝唔急太監急
皇曆|通勝
皮兒皺|巢皮
皮兒薄|脆皮
皮兒|衣
皮包公司|空殼公司
皮包|手袋
皮包骨|皮黃骨瘦
皮厚|韌皮
皮夾|銀包
皮帶|褲頭帶
皮板兒|皮板
皮條客|烏龜
皮猴兒|雪褸
皮筋兒|橡筋箍
皮粗肉厚|韌皮
皮缸|大甕缸
皮脆|脆皮
皮膚光滑|滑脫脫
皮膚皴裂|爆圻
皮膚|肉地
皮袍兒|皮袍
皮襖|皮衲
皮貨的總稱|皮草
皮開骨散|甩皮甩骨
皺|巢
皺折|摺
皺紋|打摺
皺縮|絣
皺裂|爆㿭
盅飯|盅頭飯
盎司|安士
盎斯|安士
盒式收錄機|卡式機
盒式錄音機|卡式機
盒飯|盒仔飯
盒|餅
盛住|兜
盛入|裝
盛氣凌人|聲大夾惡
盛水|裝水
盛盤|上碟
盛第二碗飯|添飯
盛飯|拂飯
盛飯的勺子|飯殼
盛飲食的器具|碗
盛魚用戶竹器|魚笭
盜竊|爆竊
盜賊的巢穴|蛇竇
盜賊|賊佬
盞|眼
盟兄弟|砂煲兄弟
盡了力|交足功課
盡了|盡好
盡全力工作|搏命
盡全力|搏到盡
盡情表現|也文也武
盡情賣弄|大騷
盡|盡好
盡興|夠味
盡頭封閉|掘頭
盡頭|豚
監測器|電眼
監牢|監
監獄|監倉
監看|監視
監督|督
監視器|熒幕
監視|望
盤成餅狀|打蛇餅
盤杠子|打杠架
盤踞|打躉
盤香|塔香
盥洗室|沖涼房
盧安達|盧旺達
目不轉睛|眼定定
目光呆滯|眼光光
目光貪婪|眼甘甘
目前|而今
目力|眼界
目呆呆|目瞪瞪地
目的在於|志在
目的|目的
目瞪口呆|眼瞏瞏
盯|𥄫
盯梢|吊尾
盯準|吼準
盯緊|噏實
盲人|盲公
盲女|盲妹
盲目地|錑個頭埋去
盲目自大|沙塵
盲腸|橫丫腸
直來直往|屈擂槌
直到|至到
直哼哼|牙痛咁聲
直尺|間尺
直截了當|直白
直打哆嗦|揗揗震
直挺挺|直筆甩
直|掂
直接|直頭
直搗巢穴|冚竇
直流電|乾電
直溜溜|直不甩
直爽|直筆甩
直牲子|直腸直肚
直立|打直
直站著|戙企
直腸子|直腸直肚
直著|打掂
直通汽車|直通巴士
直達火車|直通車
相互配合|夾手夾腳
相似|似
相來往|通
相信|信
相像|似樣
相像或比喻|噉
相公|契弟
相冊|相簿
相同|同
相同"|同埋
相容|兼容
相幫|相就
相形之下|補開
相思豆|紅豆
相思鳥|相思
相投合|埋欄
相救|搭救
相框|相架
相照|影相
相熟的客人|熟客仔
相片|相
相當一段時間|一牌
相當好|不俗
相當|激
相稱|戥稱
相處|相與
相襯|合襯
相親|相睇
相貌|口面
相貌敦厚|好福厚
相貌端正|貴相
相貌醜陋|鬼怪
相連|孖
相連的兩間房子|孖屋
相邀|摟
相配|合襯
相面|睇相
盼也盼不回來|欿唔返
盼來盼去|望嚟望去
盼望|恨
省下|慳返
省城|省
省得|費事
省|慳
省省吧！|慳啲啦！
省著用|慢慢搣
省錢|慳水
省點口水|慳番啖氣
眉梢向上吊起|倒吊眼眉
眉毛|眼眉毛
眉目傳情|丟眼角
眉目清秀|好眉好貌
眉目送情|拋眉眼
眉眼高低|眉頭眼額
看一看|望望
看上去|睇落
看上|睺
看不下去|睇唔過眼
看不到|望唔到
看不清東西|唔夠眼
看不清楚|矇
看不清|眼矇矇
看不破|唔化
看不起人|眼角高
看不起|睇落
看不開|唔化
看中|睇啱
看中醫|睇脈
看了過去|看回
看仔細|睇直
看你還敢不敢|問你怕未
看來|睇落
看到|望到
看在錢的份上|睇錢份上
看夜|看更
看好|睇旺
看守得很嚴密|睇到拫
看守攤子|看檔
看守|相
看守著|看着
看守門戶|睇門口
看守龍門|守龍門
看家戲|手本
看家本事|手本戲
看家狗|門口狗
看家|睇頭睇尾
看小了|看低
看待|見得
看得上|睇上眼
看得入迷|睇飽眼
看得出|睇白
看得夠了|睇飽眼
看得懂|睇得明
看得準|好眼界
看得起|睇起
看得過去|合眼
看得開|睇破
看房|睇樓
看扁|睇衰
看手相|睇手掌
看攤兒|看檔
看攤子|擺檔
看更|睇更
看樣品|睇辦
看樣本|睇辦
看機器|睇偈
看死了|睇死
看淡了|心淡
看淡|睇淡
看清楚一點|看真一點
看清楚|睇真
看準了之後|睇定啲
看準|睇定
看熱鬧|食花生
看球賽|睇球
看病|睇症
看盡|睇晒
看相|照田雞
看看有沒有|睇見冇見
看看|睇下
看真切|睇真
看|睇
看破|睇化
看著不順眼|礙眼
看著|望住
看著生氣|眼火爆
看著辦|執生
看行情|睇市
看財物|起痰
看走了眼|跌眼鏡
看走眼|睇漏眼
看起來|睇落
看蹭戲|睇霸王戲
看輕|睇小
看透了|睇化
看透事物|好眼
看透|睇穿
看遍|睇勻
看醫生|睇醫生
看重|睇高
看重臉面|顧面
看錢最重|睇錢緊
看門兒|睇門口
看門口|守門口
看開了|睇化
看頭兒|睇頭
看顧|照起
看風聲|睇水
看風頭|睇勢頭
真假難分|神神化化
真|勢
真壞|衰衰噉
真好運|好彩
真實的情況|實情
真實|真
真實資料|堅料
真巧|恁啱
真是個|正一
真是|正一
真東西|真家伙
真棒|認真㜺鬼
真正是|真係
真正|真係
真沒意思|好冇癮
真的一樣|真嘅一樣
真的是|真係
真的|真係
真相大白|一天光晒
真糟糕|真棹忌
真要命|真攞命
真誠|君真
眨眼睛的神態|眼斬斬
眨眼|蹔眼
眯縫着|矇
眯縫|矇
眯縫著眼的樣子|眼矇矇
眼中釘|頂心杉
眼光不友善|眼超超
眼光含怒|眼掘掘
眼光正確|明
眼兒較疏的竹篩子|疏籬
眼力不佳|唔夠眼
眼力不準|冇眼界
眼力好|好眼界
眼大肚子小|眼闊肚窄
眼尖|眼利
眼巴巴|眼光光
眼梢|眼尾
眼淚汪汪|眼濕濕
眼淚|眼水
眼珠兒|眼核
眼珠子|眼核
眼珠子轉來轉去|眼睩睩
眼珠滴溜兒亂轉|眼仔碌碌
眼珠|眼核
眼球鼓起|凸眼
眼疾|鬥雞眼
眼皮下垂|眼耷耷
眼皮浮腫|眼䏨䏨
眼皮直跳|眼眉跳
眼皮跳動|眼眉跳
眼眶濕潤|眼濕濕
眼睛一大一小|大細眼
眼睛上火|眼熱
眼睛很大|眼大大
眼睛昏花|眼花花
眼睛有準頭|好眼界
眼睛模糊|矇查查
眼睛毛兒|眼挹毛
眼睛生在頭頂上|眼睛生響頭頂
眼睛|眼
眼睛瞪得鼓鼓|眼凸凸
眼睛蛇|飯鏟頭
眼睛骨碌碌轉|眼仔睩睩
眼睜睜|眼光光
眼瞼膏|眼影
眼紅|眼熱
眼線|線眼
眼花繚亂|眼花花
眼藥水|眼水
眼袋|眼肚
眼觀六路|一眼關七
眼角|眼尾
眼跳|眼眉跳
眼都瞪直了|眼都凸埋
眼鏡框|鏡架
眼鏡王蛇|過山風
眼鏡腿兒|眼鏡髀
眼鏡腿|眼鏡髀
眼鏡蛇|飯鏟頭
眼饞肚飽|眼闊肚窄
眾人參與說笑|儕嘩嘩
眾人|大朋
眾人起哄|譁
眾叛親離|斷六親
眾目睽睽|百眾
着地|掂地
着急|心急
着惱|火滾
着手|埋手
着火了|火燭
着火|搶火
着迷|暈大浪
睜一隻眼閉一隻眼|隻眼開隻眼閉
睜大眼睛注視|睩
睜大|碌大
睜大雙眼|瞪大對眼
睜眼瞎|開眼盲
睜眼說瞎話|擘大眼講大話
睜|睩
睜著眼|眼光光
睜開眼睛|開眼
睡不安穩|囉囉攣
睡在地上|轆地沙
睡地板|廳長
睡大覺|大覺瞓
睡得好|好瞓
睡得死|好瞓
睡得熟|好瞓
睡椅|懶佬椅
睡眠不足|烏眉瞌睡
睡眠狀態結束|醒
睡眼惺忪|霧霧淞淞
睡眼惺鬆|眼矇矇
睡|瞓
睡著了|搵周公
睡覺|搵周公
睡覺覺|覺覺豬
睡飽|瞓成
督促|督
睪丸|春袋
睫毛|眼揖毛
瞄一下|瞄下
瞄|睄
瞇|瞌
瞇著眼|矇住對眼
瞎吹|得把口
瞎嚷嚷|呱呱叫
瞎女人|盲婆
瞎女|盲妹
瞎子|盲仔
瞎忙|混吉
瞎扯一通|亂車廿四
瞎扯|大隻講
瞎指揮|亂指廿四
瞎摸合眼|盲摸摸
瞎摸|盲摸摸
瞎撞|盲摸摸
瞎猜|斷估
瞎|盲眼
瞎編|喋
瞎蒙|斷估
瞎說一氣|亂講冇為
瞎走|盲摸摸
瞎騙|老點
瞎鬧|亂嚟
瞟|䚕
瞠目結舌|擘大個口得個窿
瞧不起|睇衰
瞧著|𥇣住
瞪大了眼|眼凸凸
瞪著眼睛|眼睩睩
瞪|覴
矇騙人|博懵
矇騙買主|捉雞腳
矛盾|拗撬
知了|秋蟬
知書識字|知書識墨
知會|照會
知識|識
知趣|識做
知道利害|知死
知道好歹|知衰
知道|知
知錯|知衰
矬子|三寸釘
短信|短訊
短刀|刀仔
短大衣|中褸
短小|奀
短小精悍|矮啲腯
短尾|屈尾
短時間|一時三刻
短時間地烤|燂
短時陣雨|過雲雨
短槍|短火
短版法國麵包|豬扒包
短短|短切切
短褲|牛頭褲
短路|黐綫
矮且胖|短度闊封
矮人|矮磨碌
矮凳|凳仔
矮子|矮仔
矮小|矮細
矮胖的人|磨碌
矮胖|矮腯腯
矯健|跳跳紮
石榴|花棯
石油氣鋼瓶|煤氣罐
石油液化氣|煤氣
石灰水|灰水
石階|石級
石頭剪子布|猜呈尋
石頭|石
砂鍋|瓦煲
砂鍋飯|煲仔飯
砈|砹
砌墻刀|磚刀
砌磚抹牆的工作|泥水
砍掉|斬去
砍|斬
砍除|剷走
研磨|磨
砰|乓
破了個洞|穿咗個窿
破傷|損
破壞利益|倒米
破壞契約|踢契
破壞|扠涴
破|崩
破損|𤿎
破東西|衰嘢
破格|出位
破水|破水囊
破爛不堪|爛茸茸
破爛|茸茸爛爛
破爛貨|爛鬼嘢
破玩藝兒|衰嘢
破界|出位
破破爛爛|融融爛爛
破碎|碎
破紀錄|打爆機
破罐破摔|拚爛
破罐破甩的人|爛命
破裂|崩
破費|過費
破銅爛鐵|爛銅爛鐵
破鑼嗓子|老牛聲喉
砸了|涴
砸剪包|包剪搥
砸地基|打樁
砸落|啄
砸衣服|車衣
砸鍋|倒灶
砸頭|扑頭
硌得慌|哽
硌|梗
硬來|夾硬
硬充|充硬
硬卡紙|咭紙
硬幣|銀仔
硬幹|監粗嚟
硬性|硬板
硬撐|死撐
硬是|係都
硬朗|硬掙
硬梆梆|硬弸弸
硬紙片兒|卡紙
硬紙片|咭
硬紙|紙皮
硬而實|實趯趯
硬背|死背
硬莖|骨
硬著頭皮幹|頂硬上
硬要|硬係
硬頂著幹|頂硬上
硬體|硬件
硯台|墨硯
硯臺|墨硯
碎嘴|口痕
碎嘴子|口痕
碎屑|糠
碎布|布碎
碎布片|布碎
碎末|茸
碎殼|殼碎
碎牛肉|碎牛
碎米|米碎
碎紙|紙碎
碎而爛|茸茸爛爛
碓接觸米的部分|碓頭
碗|兜
碗底子|飯腳
碗底|碗篤
碗櫃|缽櫃
碗麵|杯麵
碰上好運氣|撞彩
碰到兇險|見鬼
碰壁|撞板
碰巧|撞啱
碰手氣|撞手神
碰撞|磕
碰杯|飲杯
碰見|遇
碰運氣|撞彩
碰釘子|撞板
碳酸鈉|梳打
確信|知實
確定|直晒
確實|真個
確屬|正一
確認|落實
確鑿無疑|的而且確
確鑿的消息|堅料
碼頭|埠頭
磁片|磁碟
磁石|攝石
磁鐵|攝石
磕碰|搉
磕膝蓋兒|膝頭
磚塊|階磚
磚砌的雞舍|雞屋
磨叨|譖氣
磨噌|姿整
磨心|夾心人
磨損|𤿎
磨牙|齧牙
磨碎|研碎
磨磨蹭蹭|咪咪摸摸
磨蹭|姿整
礅|戙
礙事|阻
礙地方|阻定
礙手礙腳|馱手掕腳
社區|屋苑
社會地位|江湖地位
社會工作者|社工
社會最底層的人|草根階層
社神所在|社壇
社神|社公
祈禱給神聽|稟神
祕|秘
祕訣|貼士
祖先的統稱|太公
祖先|老祖
祖國|唐山
祖墳|家山
祖墳風水好|背脊厚
祖宗牌位|神主牌
祖宗|老祖
祖母孫子兩人|兩婆孫
祖父|阿爺
祛邪|治邪
神不守舍|失魂
神主|神主牌
神仙也沒轍|神仙難救
神位|神主牌
神奇的功夫|神功
神奇|神化
神妙|神化
神志不清|迷迷懵
神情自若|氣定神閑
神憎鬼厭|神台貓屎
神氣|威水
神清目爽|精神爽利
神秘|神化
神經失常的男人|白痴佬
神經失常|黐線
神經漢|白痴佬
神經病|黐筋
神聊|儕嘩嘩
神色慌張|失魂
神通|把炮
神采奕奕|醒神
神魂顛倒|暈浪
票券|飛
票友|臨記
票證|證
票|飛
禁不住|唔禁
禁不起|唔禁
禁玩兒|玩耐
禁用|襟用
禁穿|襟著
禁聽|襟聽
禍不單行|衰開嚟有頭有路
禍害|殃禍
禍福|三衰六旺
福氣|幾生修到
禮物|手信
禮節很周全|禮儀周周
禮節|禮數
禮衣旁|禮衣邊
禮貌|禮數
禽畜內臟|雜
禽類的內臟|腑胵
禽類的肫肝|扶翅
禾鐮|鐮刀
禿子|光頭佬
禿|屈頭
禿禿|倔擂槌
秀氣|菂式
私下出讓|自讓
私人問題|貼身問題
私人小汽車|座駕
私人樓宇|私家樓
私人|私家
私塾|書館
私塾開學|開館
私己錢|私己
私房話|密偈
私房錢|私己
私有|私家
私生子|野仔
私自搭建非法建築物|僭建
私蓄|私己
私語|咿咿咠咠
私通消息|通水
私鑰|私人密碼匙
秋千|千秋
秋豆|棉豆
科隆香水|古龍水
秘密|密
秘密話|密偈
租房子|租樓
秤一秤|戥一戥
秤子|戥子
秤|磅
移動|搬去
移平|鏟平
移花接木|斬雞頭換雞腳
移|褪
移走|剷走
移過來|褪過
移除|整走
稀|削
稀奇古怪|古靈精怪
稀屎|渜
稀巴爛|爛笪笪
稀泥|爛湴
稀溜溜|稀淋淋
稀灰漿|灰水
稀爛|爛
稀疏|疏罅
稀疏的鬍子|師爺鬚
稀疏貌|疏疏列列
稀稀拉拉|離行離罅
稀釋劑|天拿水
稀釋|勼稀
稀里嘩啦|時哩沙啦
稀里糊塗|烏垂垂
稀雞屎|雞渜
稀飯|白粥
稅|税
程序|架步
程度|度
程度很深|犀飛利
程度深|翻天
程度高|飛起
稍後|遲啲
稍微|略略
稍為|略略
稍稍|稍為
稗子|稗
稗草|稗
稟公處理|揸正嚟做
稠密|密窒窒
種地|耕田
種子|仁
種牛痘|閹痘
種類|份
稱心|合心水
稱手|就手
稱新娘的弟弟|舅爺仔
稱母親的祖母|外太婆
稱母親的祖父|外太公
稱物時的分量|秤頭
稱讚|讚
稱贊|贊
稱霸|靠指鼻
稱體弱的人|虧友
稻田|禾田
稻草|禾稈
穀子|狗尾粟
積垢|積
積德|積陰功
積怨|仇口
積攢|積
積極|投入
積滿|塳滿
積福|積陰功
積纍|積
積蓄|儲埋
積陰德|積陰功
積體電路|集成電路
穩妥|穩陣
穩定|定
穩當|定當
穩站|企硬
穩重|倓定
究竟|到底
空中女服務員|空姐
空中小姐|空姐
空屋|吉屋
空心|空籠
空心菜|通菜
空心蘿蔔|花心蘿蔔
空房子|吉屋
空手|兩梳蕉
空有|賺得
空歡喜|詐糊
空氣不流通|翳焗
空氣|氣
空當兒|空檔
空着肚子|空肚
空空如也|空寥寥
空空|空寥寥
空罐頭罐|嘜
空置房子|吉屋
空腹|空肚
空落落|空寥寥
空著|空住
空蕩蕩|空框框
空調|冷氣機
空談|煲冇米粥
空身|光身
空車|吉車
空閒的時候|空檔
空閒|空檔
空間大|闊落
空間|碇
穿了個洞|穿窿
穿了個窟窿|穿窿
穿制服的警察|軍裝警員
穿孔|穿窿
穿幫|穿崩
穿得整齊|執得正
穿洞|穿窿
穿|着
穿著破爛|爛身爛勢
穿衣少|單薄
穿衣打扮|裝身
穿衣服|著衫
穿西裝的人|西裝友
穿過山洞|鑽山竉
穿過|鑽
突兀|鶻突
突出的木頭|枅
突出的軟骨或肉|枅
突出|䅺青
突圍而出|發圍
突尼西亞|突尼斯
突擊|惡補
突然一驚|躓
突然停止|窒
突然停|躓
突然怒氣沖天|火蓋頂
突然發火|火遮眼
突然|突兀
突然醒來|扎醒
突|齙
窄小局促|淺窄
窄小而擁擠|逼狹
窄巷|冷巷
窄狹|淺窄
窄腰|揸腰
窄|逼
窈窕|镽細
窗上的鐵欄|窗枝
窗子|窗門
窗戶位置|窗口位
窗戶旁邊|窗邊
窗戶|窗口
窗扇|窗門
窗柵欄|窗枝
窗格子|窗花
窗欞|窗花
窗簾兒|窗簾
窟窿|窿
窩兒裏橫|門口狗
窩囊廢|冇料
窩心|頂心頂肺
窩心馬|歸心馬
窩火兒|谷氣
窩瓦河|伏爾加河
窩|竇
窪處|凹
窮人|窮鬼
窮凶極惡|惡死能登
窮困潦倒|褲穿窿
窮得叮噹響|拍手冇塵
窮得沒飯吃|搵朝唔得晚
窮得無米下鍋|倒吊沙煲
窮極|吞口水養命
窮途|掘頭路
窺|𥄫
窺探虛實|睺下路
竄|標
竅門|貼士
竊竊私語|咿咿咠咠
竊門|穚
立人兒|企人旁
立刀兒|刀字邊
立刻|即刻
立即|即刻
立場堅定|企硬
立式|企身
立|戙
立柜|企身柜
立案|落案
立櫃|高柜
立法|立例
立體聲|身歷聲
站不直|冇腰骨
站|企
站在門坎上|徛門槧
站立|企立
站立的位子|企位
站籠|徛籠
站著|戙篤企
站起來|起身
站都沒處站|企都冇地企
章魚|八爪魚
童子軍|童軍
童言無忌|大吉利是
童養媳|新婦仔
竭力|起勢
竭盡全力|搏晒老命噉
端午節點的香|蚊煙香
端午節|龍舟節
端正|四正
端起|搊
競爭劇烈|爭崩頭
競爭|摙
竹字頭|竹花頭
竹杠|竹升
竹板席|光邊竹席
竹槓|竹升
竹竿|竹篙
竹筍炒肉絲|藤條炆豬肉
竹簽兒|竹枝
竹編的器具|篱
竹編的小籮筐|菜籮
竹編的洗菜用具|筲箕
竹編的籮筐|籮
竹葉青蛇|青竹蛇
竹葉青|青竹蛇
竹部|竹花頭
竿子|杉
笊籬|罩籬
笑口常開|笑口噬噬
笑咪咪|笑微微
笑哈哈|笑口噬噬
笑嘻嘻|笑口吟吟
笑容滿面|笑口吟吟
笑容燦爛|見牙唔見眼
笑得在地上打滾|笑到碌地
笑得很厲害|笑到腸都攣
笑得肚子疼|笑到腸都攣
笑掉大牙|笑甩棚牙
笑掉整排牙齒|笑甩棚牙
笑模樣|笑口噬噬
笑的模樣|煠熟狗頭
笑的樣子|見牙唔見眼
笑眯眯|笑笑口
笑瞇了眼|見牙不見眼
笑著|笑笑口
笨人|薯頭
笨伯|老襯
笨到|懵到
笨小孩|壽仔
笨手笨腳|龍龍鍾鍾
笨拙的男子|壽仔
笨拙|龍鍾
笨蛋|暓里
笨豬|豬嘜
笨透了|蠢到極
笨頭笨腦|惃頭惃腦
第一口湯|頭啖湯
第一手|第一身
第一把手|一哥
第一|頭一
第二天|第日
第末|第尾
筆套|筆錔
筆尖上蘸得太飽|淰
筆尖兒|筆嘴
筆尖|筆嘴
筆帽|筆錔
筆直|直筆甩
筆記型電腦|手提電腦
等一下|等陣
等一會兒|等陣
等一等|咪住
等到|留返
等到脖子都酸|望到頸都長
等待|等緊
等待隊伍|條隊
等得太久|頸都長
等着用|等使
等等|等埋
等著瞧|畀眼睇
等著|等住
等這麼長時間|等咁耐
等閒視之|好閑
筍雞|童子雞
筏子|排
筒|嘜
答應|應承
答理|睬
答答|納納
答腔|答嘴
答茬兒|搭嘴
答言|答嘴
答話|答搔
答謝神明|還神
策劃|劃
筷子|箸
箍|括
箍緊|逼
算了吧|由得佢
算了|罷啦
算命先生|相士
算命|批
算好了|計
算帳|埋數
算成本|為皮
算我的|入我數
算術上的除法|除
算計人|扭計
算計|煲
算起來|計落
管事者|執事
管他呢|話之佢
管他的|關人喇
管保|包保
管制人|收人
管制|剋治
管子|喉
管它|唔理佢
管工|科文
管束|制治
管燈|光管
管理員|看更
管理|打理
管用|使得
管賬|揸數
管路|窿路
管轄下的地方|地頭
管道|渠道
管鉗子|喉鉗
管錢|揸錢
節儉|慳皮
節日放的煙火|煙花
節省下來|慳埋
節省位置|慳位
節省地方|慳位
節省|慳儉
節約|慳
節約用水|慳水
節課|堂
築|起
篤定|坐梗
篦子|篦
篩子|篩
篩走|飛
簇新|光鮮
簡化字|簡體
簡單地|簡單噉
簡直|直頭
簡訊|短訊
簡陋|屈質
簡體字|減筆字
簡體|簡筆
簪子|頭簪
簪形的物品|笄
簸箕|篸
簽兒|籌
簽出|簽走
簽名|簽署
簽章|簽署
簽署|簽定
簿子|簿
籃子或籃形物|藍
籃子|手抽
籃子的提梁|籃耳
籃球的跳球|針球
籚花黃雀|相思
籠子|籠
籠屜|籠
米中的小蛀蟲|穀牛
米其林|米芝蓮
米|咪
米樣子|米辦
米湯|飯湯
米的一個品種|矮腳占
米的氣味|米氣
米皮|糠
米粉條的一種|瀨粉
米粉條|粉
米花糕|米通
米花糖|米通
米蘭花|米仔蘭
米蟲|蛀米大蟲
粉公仔|麵粉公仔
粉刷墻壁|掃灰水
粉刷牆壁|掃灰水
粉刺|酒米
粉剌|酒米
粉末|粉
粉碎|溶溶爛爛
粉筆擦子|粉擦
粗壯有力|起腱
粗壯|起腱
粗大的纜繩|大纜
粗心|冇手尾
粗心大意|大頭蝦
粗心的人|大頭蝦
粗心鬼|大頭蝦
粗條狀粉條|瀨粉
粗生|爛生
粗略估計|大大話話
粗略地拴住|褦
粗略地看|擸
粗竹杠|竹升
粗笨|陋包
粗粗地搓洗|捼
粗繩|纜
粗言穢語|爆粗
粗話|爛口
粗野|牛皋
粗鐵棍|鐵筆
粗體|粗字
粗魯|牛
粗鹽|生鹽
粗麻布|菠蘿麻
粘著|黏住
粘貼|黐
粘連|黐
粘|黐
粳稻米|肥仔米
粵劇唱腔|喉
粵劇|大戲
粵劇演員|通堂老倌
粵語舊片子|粵語殘片
精光|清光
精巧|妙品
精彩部分|戲肉
精心炮製|撚手
精於喝酒的人|飲家
精於某種事人|家
精於某行業者|骨
精於此道|識
精於飲食|揀飲識食
精於飲食的人|食家
精明乖巧|精乖
精明的男子|精仔
精明能幹|精嚦
精明|醒目
精神不大正常|黐筋
精神不太正常|神經
精神不正常|神神經經
精神十足|龍精虎猛
精神受創|落晒形
精神奕奕|精神爽利
精神恍惚|失魂
精神恍惚的人|失魂魚
精神抖擻|精神爽利
精神有點不正常|神神地
精神狀態差|冇精神
精神病患者|癲佬
精神病發作|發花癲
精神病|黐綫
精神|英氣
精細|幼細
精緻|撚手
精肉|脢肉
精致玲瓏|玲瓏浮突
精靈古怪|古靈精怪
精鹽|淮鹽
糊塗之極|懵上心口
糊塗事|烏龍事
糊塗|懵
糊塗無知|懵懂
糊塗蟲|烏龍王
糊弄|搵笨
糊糊塗塗|迷迷懵懵
糊里糊塗|矇查查
糕點一種|馬拉糕
糖尿病|甜尿
糖果盒子|全盒
糖果盤|攢盒
糖果|糖
糖果類|糖
糖桂花|桂花糖
糖梨|沙梨
糖玫瑰|玫瑰糖
糖腌冬瓜條|糖冬瓜
糖腌製|糖
糖醋排骨|生炒骨
糖醋炸肉|咕嚕肉
糖醋炸里脊|咕嚕肉
糖醋里肌|咕嚕肉
糖醋魚|五柳魚
糞便|茄
糞|屎
糞蛆|屎坑蟲
糞霸|屎埠
糟了|舐嘢
糟模樣|衰樣
糟糕了|瀨嘢喇
糟糕|弊
糟踐|作賤
糟蹋|糟騭
糠蘿蔔|花心蘿蔔
糧店|米舖
糧食|糧
糨|杰
糯穀爆的米花|爆穀
糯米甜酒的渣|酒渣
糰子|餈
糸字底|繞絲底
糸字旁|繑絲邊
糾紛|拗撬
糾結|繞
糾纏不休|纏身纏勢
糾纏|纏
糾集同伙|班
約好|佮啱
約定|定
約數|頭
約會|有約
約束|趜
紅乎乎|紅卜卜
紅了呱嘰|紅當蕩
紅利|紅
紅包|利巿
紅十字會|紅會
紅嘴相思鳥|桂林相思
紅外線|紅外光
紅寶石|火鑽
紅封包|利是
紅小豆|赤小豆
紅彤彤|紅當蕩
紅扑扑|紅卜卜
紅撲撲|紅粉緋緋
紅木|酸枝
紅桃|杏桃
紅毛鬼|紅毛
紅汞|紅汞水
紅潤|紅粉緋緋
紅燒|炆
紅白喜事|紅白事
紅皮瓜子仁|瓜子肉
紅眼鱒|大眼雞
紅種人|紅番
紅糖|片糖
紅紅|紅當蕩
紅紙包|利市
紅綠燈|交通燈
紅臉|面紅面綠
紅色乾薑|涼薑
紅色的小橘子|硃砂桔
紅色的柑|硃砂柑
紅色衣服|紅衫
紅萍果|蛇果
紅葡萄酒|缽酒
紅藥水|紅汞水
紅蘿蔔|金筍
紅通通|紅當當
紅顏色|紅
紇縫襟兒|挑紐耳
紈絝子弟|二世祖
納|篸
紐孔|紐門
紐西蘭|新西蘭
純正|正斗
純金|九九金
紙做|紙紮
紙包不住火|紙包唔住火
紙屋|靈屋
紙屑|紙碎
紙幣|銀紙
紙本子|簿
紙版|紙皮
紙牌|啤牌
紙糊的人物|紙紮公仔
紙袋|紙角
紙鈔|銀紙
紙錢|金銀紙
紙鎮|銅紙笮
素什錦|齋鹵味
素月餅|素月
素質不好|不夠質素
素質差|不夠質素
素質|質素
素食|齋
素|齋
索羅門|所羅門
索馬利亞|索馬里
索高價|開天索價
紫外線|紫外光
紫藥水|藍藥水
紮辮子|紮辮
累壞|挨壞
累|攰
累死累活|死做爛做
累贅|馱手掕腳
細嫩|嫩
細小|幼細
細|幼
細心|好心機
細想一下|恁落
細想之後有所|諗落
細碎|碎淫淫
細節|細節
細米糠|幼糠
細細地相連|乃
細細長長|嫋嫋瘦瘦
細緻|骨子
細聲細氣|陰聲細氣
細膩|幼滑
細菌|微菌
細長|镽
細雨|雨溦
細雨飄零|雨粉粉
終之|卒之
終於|卒之
終|晚
終會|終須
終有一天|一日
終有漏洞|百密一疏
終歸|終須
終生不嫁|梳起
終究|終須
終端|終端
終身獨身的女子|自梳女
組合|砌
組裝|嵌
絆|戟
結了婚|拉埋天窗
結交|群
結伙|埋堆
結婚三天後|擔茶
結婚後第三天|三朝
結婚|拉埋天窗
結婚時的女人|新娘
結實|硬淨
結尾|埋尾
結巴|吃口
結帳|埋單
結成|做
結拜|拜案
結束工作|晒攤
結束放映|落畫
結束程式|行開
結束|退出
結果|話結
結清賬目|清盤
結為乾親|契
結球甘藍|椰菜
結球白菜|紹菜
結痂|結𥀬
結算|埋數
結結巴巴|口窒窒
結|纈
結賬|埋單
絕好的計劃|絕橋
絕妙的計策|絕世好穚
絕對|實
絕市|斷市
絕情|屈情
絕招|秘技
絕無辦法|一戙都冇
絞刑|環首死刑
絞絲旁|繑絲邊
絞腦汁|想壞腦
絞臉|打線刀
絣衫尾|拉衫尾
給上司責罵|照肺
給不了|給不到
給予|畀
給予食物|喂
給人看相的人|相士
給以|畀
給嚇倒了|嚇窒
給好處|益
給定|指定
給定錢|落定
給小費|打賞
給得又多又便宜|大件抵食
給我滾！|同我躝！
給我答案|答到我
給|畀
給面子|畀面
絨螫蟹|大閘蟹
絨衣|波恤
絮叨|吟噆
絮絮不休|雞啄唔斷
絮絮叨叨|講耶穌
統一口供|夾口供
統統|冚
統考|會考
統艙|大艙
絲毫|厘
絲瓜|勝瓜
絲瓜棱兒|棱
絲部|繞絲邊
絹子|手巾仔
綁票|標參
綑|綁
綑綁|綁
綑緊|爪
經一事長一智|多一事長一智
經受過|試過
經常|周不時
經常哭叫|大喊十
經常生病|病君
經常變化|冇時定
經常賭氣|鼓氣袋
經得起|抵得
經手|過手
經月|見使
經歷過|試過
經濟不繁榮|市道低迷
經濟寬裕|鬆
經濟收入|入息
經濟糾紛|錢銀糾紛
經營不正當行業|撈偏門
經營的費用|皮費
經理|大班
經由|透過
經花|見使
經費支絀|支支繃繃
經過|經
經過脫水|乾水
綠綠|青啤啤
綠繡眼|相思
綠色|青
綠豆做的澱粉|豆粉
綠頭鴨|野水鴨
維京|維爾京
維吉尼亞|維珍尼亞
維夫餅乾|威化餅
維德角|佛得角
維持費|皮費
維持|頂檔
網友|巴絲打
網狀織物|厘士
網球|聽尼士
網路|網絡
網際網路|互聯網
綽號|花名
緊密合作|拍硬檔
緊密|緊緊
緊|實
緊巴巴|繃繃繄
緊張|衡晒
緊拉|繃
緊盯著|睇實
緊箍|趜
緊繃|梆梆緊
緊跟|追貼
緊迫|擠迫
緊追|追貼
緊隨|追貼
"線上|喺網上
線上|網上
線人所提供的報告|線報
線條|條綫
線毯|珠被
線狀的乾米粉條|米粉
線|綫
線軸兒|線轆
緣份珍貴|有今生冇嚟世
編織|織
編號|冧巴
編輯|老編
編造事實|生安白造
編造|喋
練武功|食夜粥
練武術|打功夫
練習|練埋
緻密|結
縫住|釘
縫窮婦|補衫婆
縫紉機|衣車
縫紉用語|鎖
縫紉|車衫
縫綫綻開|甩綫
縫線|線步
縫|聯
縫補鞋|錐鞋
縫隙|罅
縫麻袋|包針
縮在角落里|縮埋一二角
縮寫|撮寫
縮小|縮細
縮小規模|縮皮
縮手縮腳|躓手躓腳
縮排|褪入
縮水|折水
縮進|縮入
縱容|容縱
總之|總言之
總是|成日
總會|不多不少
總|終須
總而言之|總言之
總開關|大制
總閘|大掣
總閘門|大掣
繁瑣的事物|乜乜物物
繁華|旺
繁體字|舊體字
繃緊|拫
繅蠶絲|繅繭
繐子|繐
織女|七姐
繚紐襻兒|挑紐耳
繚衣服的底邊|挑腳
繚貼邊|挑腳
繚邊兒|挑腳
繞了個大圈兒|行大運
繞口令|急口令
繞圈|兜圈
繞彎兒|打個框
繞樑三日|聽出耳油
繞腳|撠腳
繞路走|運
繞路|運路行
繞道兒走|運路行
繞道|運
繡花枕頭|倒瓤冬瓜
繩子|繩
繩結|結
繪畫|畫公仔
繫上|綁
繫帶|𦂗帶
繫|攬
繫緊|綁實
繫著|掕住
繫錶的鏈子|錶鏈
繳費|入錢
繼父|後底爺
繼續加拍|添食
繼電器|士撻
纍計起來|積積埋埋
纍贅|累世
纏住|黐
纏在一起|一箸菜
纏綿|黐纏
纏繞不休|死纏爛打
纏繞|纏
纏繞莖|藤
纏腳婆娘|纏腳娘
纏著不放|死纏爛打
纏足布帶|纏腳帶
纖細|瀟湘
纜繩|纜
缺一個人|三缺一
缺不得|唔少得
缺乏常識|冇眼界
缺乏條理性|冇厘頭
缺乏餘地|抆水
缺口|崩口
缺唇|兔嘴
缺唇的人|阿崩
缺少水分|乾涸
缺德事|衰嘢
缺德女人|衰婆
缺德帶冒煙兒|衰到貼地
缺德樣兒|衰樣
缺德的人|陰功鬼
缺德|陰質
缺德鬼|衰公
缺損|崩
缺斤短兩|呃秤
缺課|走堂
缺貨|渴市
缺錢|水緊
缺門牙的人|阿崩
缺陷|甩漏
罎|䍇
罐兒|罌
罐子|罌
罐頭盒子|嘜
罩子|罩
罪名大或多|大鑊
置辦產業|置業
置辦|辦
置辦酒席請客|擺酒
罰抄書|罰抄
罵人話|鬼
罵人|講粗口
罵娘|媽媽聲
罵瘦小的人|乾
罵街的女人|嗌街婆
罵|鬧
罷了|啫
羅漢竹|觀音竹
羅鍋兒|駝背
羊毛毛綫|羊毛冷
羊毛衫的簡稱|毛衫
羊癇風|羊吊
羊|羊咩
羊羔兒|羊仔
羊角風|羊吊
美味|好味
美國政府|華府
美國華僑|金山客
美國首都華盛頓|華府
美女帥哥|靚仔靚女
美好|㜺
美妙|㜺鬼
美容院|髮廊
美差|肥蟹
美沙酮|美沙酮
美色而貪心|起痰
美艷|㼽鏡
美術勞作|美勞
美|靚
美食家|食家
美麗|靚
羞人|羞家
羞恥|羞家
羞死了|醜甩耳仔
羞死人|醜死鬼
羞聇|醜
羞辱|醜
羡慕|恨
群眾演員|臨記
群組|谷
群|羣
群鬥|開揙
羨慕死人了|恨死隔籬
義務工作人員|義工
義大利|意大利
義大利麵|意粉
義肩|假膊
羹匙|匙羹
羽毛鬆散|鬆毛鬆翼
羽絨服|太空褸
羽翼已豐|有毛有翼
羽翼豐滿|有毛有翼
翅膀硬了|有毛有翼
翅膀|翼
翎毛扇|雉雞尾扇
習慣"|例牌
習慣|慣
翠藍|姣婆藍
翹下巴|兜下爬
翹課|走堂
翹起|趷
翹辮子|拉柴
翻個兒|覆
翻找|抄
翻書|揭書
翻滾|捵
翻版|老翻
翻白眼兒|反眼
翻白眼|眼坦坦
翻筋斗|打關斗
翻臉仇視|爛
翻臉|擘面
翻臉無情|反眼
翻跟斗|打關斗
翻跟頭|打斛斗
翻身|反轉便
翻過來|反轉
翻開|搴開
翻領|反領
翻騰|反轉
翻鬆|掘鬆
耀武揚威|也文也武
耀眼|光晟晟
老一套|例牌
老丈人|外父
老不正經|老而不
老且糊塗者|老懵懂
老主人|大老爺
老了|過身
老人去世|百年歸老
老人|長者
老伯伯|阿伯
老來俏|老嚟嬌
老傢伙|老坑
老兄|老哥
老八輩子|古老十八代
老公雞|雞頭
老到|老積
老化子|乞兒
老咪著眼的毛病|眼矇
老四|阿瓜
老土|老餅
老壽星|壽星公
老外|老番
老大不小|大人大者
老大娘|伯爺婆
老大爺|伯爺公
老大|阿大
老天爺|老天
老太婆|婆乸
老套|三幅被
老套子|老套
老姑娘|老姑婆
老婆婆|阿婆
老婆子|伯爺婆
老媽兒|婆媽
老媽子|婆媽
老媽|老媽子
老嬸兒|孻嬸
老字號|舊招牌
老家伙|老柴
老家|祖家
老尼姑|師太
老師|教師
老年人|公公婆婆
老年女人|伯爺婆
老年男人|伯爺公
老年|老偶
老式|古老十八代
老弟|細佬
老得咬不動|老齧齧
老惦著|心思思
老想吃東西|為食
老想着|心掛掛
老成|老積
老招牌|舊招牌
老掉牙|古老十八代
老是想着或盼着|心思思
老是|淨係
老朋友了|老友鬼鬼
老本兒賠光|死直
老板|事頭
老板娘|事頭婆
老母雞|雞婆
老氣橫秋|老積
老氣|老積
老油子|老雀
老爺|大老爺
老爺爺|伯爺公
老琉璃|螗蝞
老生意人|生意骨
老糊塗|老懵懂
老練|老辣
老繭|枕
老花樣|三幅被
老處女|老姑婆
老行家|老行專
老表親|老表鬼鬼
老調|三幅被
老警察|老差骨
老部下|老臣子
老鄉|鄉里鬼鬼
老闆|事頭
老闆娘|事頭婆
老頭兒|老坑
老頭子|老坑
老馬失蹄|老貓燒鬚
老鷹|麻鷹
考住|考起
考倒了|考起
考倒|考起
考入|入讀
考慮|參詳
考文垂|高雲地利
考考眼力|考眼界
考試作弊|通水
考試失敗者|白鼻哥
考零分|食蛋
而且|兼夾
而且還|仲兼
而已|啫
耍你|水你
耍嘴皮子|得把口
耍嘴皮|賣口乖
耍太極拳|耍太極
耍弄手段|出把戲
耍弄新生|玩新生
耍弄|賣豬仔
耍心眼兒|扭計
耍性子|扭計
耍把戲|變戲法
耍新生|玩新生
耍樂地點|蒲點
耍樂|蒲
耍流氓|非禮
耍滑頭|出蠱惑
耍脾氣|使頸
耍花招兒|玩嘢
耍花招|出術
耍花樣|玩嘢
耍詐|搏懵
耍貧嘴|口花花
耍賴|發爛渣
耍賴皮|奸賴
耍麻將|竹戰
耐久力|長蓬力
耐久|禁
耐吃|見食
耐心|心機
耐心的談話|好氣
耐性|定性
耐操|禁捱
耐洗|禁洗
耐玩|玩耐
耐用|禁用
耐看|禁睇
耐穿|禁着
耐聽|襟聽
耗費言詞|勞氣
耗電|食電
耳仔旁|耳仔邊
耳垂兒|耳珠
耳垂|耳珠
耳孔|耳窿
耳挖子|耳挖
耳朵好|好耳
耳朵眼兒|耳窿
耳朵|耳
耳朵裏|耳窩
耳根機|耳仔軟
耳機子|耳筒
耳機|耳筒
耳腔|耳窿
耳語|咬耳仔
耷拉眼皮|眼耷耷
耷拉|耷
耷拉著腦袋|頭耷耷
耽擱下來|死火
耽誤別人|耽人
耽誤|阻
耿介|腰骨硬
耿耿於懷|梗心梗肺
聊天|傾蓋
聊天兒|傾世界
聊聊|傾下
聖代|新地
聖克里斯多福|聖基茨島
聖文森|聖文森特
聖誕帽子|聖誕帽
聖誕節|老番冬
聖赫倫那|聖赫勒拿
聖露西亞|聖盧西亞
聖馬利諾|聖馬力諾
聘書|關
聚在一起|埋堆
聚會|派對
聚會的地點|蒲點
聚眾鬥毆|開片
聚腳點|蒲點
聚集的地點|蒲點
聚首的地方|聚腳地
聚首|聚腳
聞到|欶到
聞聞看|聞下
聯合|聯同
聯絡|聯繫
聰敏|醒目
聰明|㔹
聰明一世糊塗一時|聰明一世蠢鈍一時
聰明人|叻仔
聰明伶俐|妙品
聰明外露|惺
聰明懂事|精乖
聰明的兒子|叻仔
聰明的孩子|叻仔
聰明的話就|精精哋就
聰明聽話|精乖靈利
聰明能幹|精㔹
聰明過頭|叻過頭
聲勢大|大陣仗
聲音刺耳|吵耳
聲音大|嘮嘈
聲音小|細聲
聲音沙啞|喉沙
聲音|聲
聲音變了|轉聲
聳|壅
職業介紹所|薦人館
職業|工
職稱|名銜
聽不懂|唔識聽
聽任|畀
聽使喚|好使好用
聽出耳茧|聽出耳油
聽到消息|收到風
聽到|聽見
聽到風聲|收到風
聽天由命|望天打卦
聽寫|讀默
聽得入神|聽出耳油
聽歌曲|聽歌
聽筒|耳筒
聽老師講課|聽書
聽覺靈敏|好耳
聽診器|聽筒
聽話|乖乖
聽說|聽聞
聽課|聽書
聽音樂|聽歌
肇菜|黃芽白
肉丁|肉粒
肉太老|肉好韌
肉排|扒
肉痛|肉刺
肉票|肉參
肉蔗|白蔗
肉酸|骨痺
肉鋪|肉檔
肉麻|肉酸
肋下|小腌
肋條|桁腩
肋骨|𩩍骨
肌肉結實|黑黑實實
肏|屌
肘窩|手坳
肚子不對勁|肚腍
肚子大|大肚腩
肚子很餓|好肚餓
肚子疼|肚痛
肚子痛|肚絞痛
肚子|肚
肚子飢餓|餓
肚子餓|肚空
肚皮向上|反仰
肚皮|肚腩
肛門|屎窟
肝兒顫|怕怕
肝|膶
股票交易所|大金魚缸
股票市場下跌|熊市
肢體麻木|瘸
肥墩墩|肥腯腯
肥大|闊
肥滋滋|肥腯腯
肥皂|番梘
肥碩|肥屍大隻
肥缺|肥蟹
肥胖|瘺囗
肥胖者|阿肥
肥頭大耳|肥頭耷耳
肩膀兒|膊頭
肩膀|膊頭
肯亞|肯雅
肯吃虧|抵諗
肯定做|做硬
肯定|奉旨
肯定是|唔使問阿貴
肯定會贏|贏硬
肯定有|有定
肯替人著想|為得人
肯為別人着想|為得人
肺都氣炸了|激到甩肺
胃口不好|翳滯
胃口大|大食
胃口大開|食指大動
胃口好|開胃
胃口小|細食
胃口|胃火
背包|背囊
背後使壞|煮重米
背後整人|煲
背後的一面|後背
背後說壞話|煮一鑊
背微駝|寒背
背脊|背脢
背著|孭住
背誦|死背
背負|馱
背靜|靜局
背黑鍋|食死貓
胎動|作動
胎毛兒|胎毛
胎記|胎痣
胎髮|胎毛
胖乎乎|肥腯腯
胖嘟嘟|肥腯腯
胖女人|肥婆
胖女子|肥婆
胖姑娘|肥妹
胖婦人|肥婆
胖子|肥仔
胖小子|肥仔嘜
胖得很結實|肥腯腯
胖男子|肥佬
胖瘦|肥瘦
胖胖|肥嘟嘟
胖頭胖腦|肥頭耷耳
胡亂|拉雜
胡亂編造|生安白造
胡亂說話|牙譫譫
胡作非為|搞搞震
胡來|亂嚟
胡同|巷
胡吹|老點
胡扯|亂噏
胡搞一通|搞三搞四
胡攪蠻纏|冇理取鬧
胡椒末|胡椒粉
胡椒粉|古月粉
胡椒面兒|古月粉
胡椒麵兒|胡椒粉
胡琴|弦索
胡瓜|青瓜
胡編|砌
胡蘿蔔|金筍
胡蜂|黃蜂
胡言亂語|亂講冇為
胡說亂吹|賣膏藥
胡說|亂噏
胡說八道|發噏風
胡豆|蠶豆
胡鬧|扭計
胳楞瓣兒|膝頭哥
胳肢|擳
胳肢窩|胳肋底
胳膊|手骨
胳膊粗壯|手瓜硬
胳膊肘兒往外不往裏|手指拗出唔拗入
胳膊肘兒朝外擰|手指拗出
胳膊肘朝外扭|手指拗出唔拗入
胳膊腕兒|手骹
胳膊腕子|手骹
胳臂伸屈不靈|跛手
胳臂|手骨
胸中有數|心知肚明
胸口|心口
胸悶|哽心
胸有成竹|定當
胸章|襟章
胸罩|捫胸
胸針|心口針
能不能|有冇得
能人|叻仔
能個兒|抵手
能做|做得
能充飢|頂肚
能力不足|二搭六
能力差|水皮
能力強|恁㔹
能力|本事
能吃|大食
能吃得飽|頂肚
能夠|得
能專心致志|有心機
能帶來好運|好腳頭
能幫得上忙|止得咳
能幹|嚦
能忍受|抵得
能忍讓|抵諗
能應變|知機
能搞多大就搞多大|有咁大搞咁大
能有幾回|有幾何
能玩|玩得
能用|使得
能耐有限|三板斧
能聊|好傾
能花錢|大使
能解決問題|止得咳
能言善辯|咯咯聲
能說會道|好辯駁
能|識
能識別人|帶眼
脂粉|粉底
脅持|騎劫
脆又甜|好爽甜
脆口|爽脆
脆嫩的生菜|玻璃生菜
脆弱|化學
脆皮蔗|白蔗
脆而甜|爽甜
脆脆的|脆曝曝
脆裂的聲音|脆卜卜
脊梁|背花
脊梁骨|背脊骨
脊骨|背脊骨
脖子不靈活|梗頭
脖子|頸
脖領兒|衫領
脖頸子|頸
脖頸|頸
脫光上身|打大赤肋
脫光膀子|除大赤肋
脫光衣服|剝光豬
脫口秀|棟篤笑
脫困|甩難
脫帽|除帽
脫手|甩手
脫檔|脫市
脫水蔬菜|菜乾
脫綫|甩綫
脫|脱
脫色|甩色
脫落|甩
脫貨|斷市
脫身|甩身
脫銷|斷市
脫離困境|甩難
脫離戀愛關係|甩拖
脫鞋|除鞋
脫骹|甩骹
脹破|䂻爆
脹脹|脹卜卜
脹鼓鼓|脹卜卜
脾氣不好|臭品
脾氣不順|梗頸
脾氣倔強|板頸
脾氣倔|要頸唔要命
脾氣合不來|攪唔埋
脾氣大|牛
脾氣好|好頸
脾氣很好的人|腍佛
脾氣暴躁|火頸
脾氣|火氣
脾氣粗魯|牛皋
腆胸|躽
腋下狐臭味|臭狐
腋下|胳肋底
腋窩|胳肋底
腌橄欖|和味欖
腌蘿卜乾|菜脯
腌蝦醬|鹹蝦
腌製果子|涼果
腌製薑|涼薑
腌製過的薑|霉薑
腐朽|霉
腐爛變質|爛
腐竹|支竹
腐臭味|蔫臭
腥膻|臊
腥|臭腥
腥臭|臭腥
腦子混亂不清|黐筋
腦子發漲|頭暈
腦殼|頭殼
腦溢血|爆血管
腦袋發漲|頭大
腦袋|頭
腦門兒|額
腦門子|額頭
腫|䏨
腮幫子|腮
腮腺炎|痄腮
腮關節|腮骹骨
腰杆子|腰骨
腰椎骨|腰骨
腰纏萬貫|豬籠入水
腰腹|肚腩
腰|䏚膁
腰身|腰圍
腰酸背痛|腰酸骨痛
腰酸腿痛|腰酸骨痛
腳制動器|腳掣
腳力|腳頭
腳囊|腳瓜囊
腳小趾|腳趾尾
腳底板|腳板底
腳手架|排柵
腳拇趾|腳趾公
腳指甲|腳甲
腳指頭|腳趾
腳掌|腳板
腳搖搖|印印腳
腳板|腳板底
腳步不穩|腳步浮浮
腳氣病|香港腳
腳氣|香港腳
腳滑|跣
腳煞|腳掣
腳病的一種|雞眼
腳癬|香港腳
腳發麻|腳痺
腳背|腳面
腳腕子|腳骹
腳|腳板
腳趾甲|腳甲
腳趾縫|腳趾罅
腳趾頭|腳趾
腳跟|腳㬹
腳跟離地|翹
腳踏剎車裝置|腳制
腳踏|踩
腳踏車|單車
腳踝|腳眼
腳蹬|腳踏
腳部痠軟|發軟蹄
腳部麻痺|腳痺
腳錢|貨腳
腳門|矮門
腳顫動不已|扤身扤勢
腳麻了|腳痺
腳麻|腳痹
腸梗阻|攪腸痧
腸粉|豬腸粉
腸胃不適|濕滯
腸胃|腸肚
腹瀉|屙肚
腹股溝|髀罅
腹部的肥肉|肚腩
腹部|肚腩
腹部鬆軟的肉|腩
腿力|腳骨力
腿向外撇開|奓腳
腿毛|腳毛
腿肚子|腳瓜
腿脖子|腳眼
腿腳|腳骨
腿軟|腳軟
腿都軟了|腳仔軟
腿長的人|長腳蜢
腿關節|腳骹
膊楞蓋兒|膝頭
膕窩|腳坳
膚色黝黑|黑黑實實
膝蓋|膝頭
膝蓋骨|膝頭髁
膠卷|菲林
膠合板|夾板
膠帶|膠紙
膠擦|擦紙膠
膠片|菲林
膨脹得鼓鼓|脹卜卜
膨脹|脹泵泵
膩味|厭
膩子|桐油灰
膻|臊
膽大包天|沙膽
膽大|膽粗
膽子大|夠膽
膽子小|細膽
膽子真大|夠膽死
膽小|細膽
膽戰心驚|騰騰震
膽敢|夠膽
膽結石症|膽生石
膽結石|膽生石
膽量|膽色
臀圍|屎片
臃腫|瘺囗
臉上個別的黑毛|面毛
臉上|塊面
臉上的細汗毛|面毛
臉上的黑斑|墨屎
臉形|面坯
臉皮厚|面懵
臉皮子薄|薄皮
臉皮薄|薄皮
臉紅紅|面紅紅
臉紅脖子粗|面紅面綠
臉色枯黃|面黃黃
臉色漲紅|面紅紅
臉色發青|面青口唇白
臉色發黃|面黃黃
臉色紅潤|紅粉花緋
臉色蒼白|面青青
臉色陰沉|苦瓜噉口面
臉色青黃|面青面黃
臉蛋兒|面珠
臉蛋|面珠
臉部浮腫|面䏨䏨
臉|面
臉頰|面珠
臉黃而浮腫|黃泡
臊味|餲
臊氣|臭胺
臊臭|餲
臊|醜
臘腸|風腸
臘製食品|臘味
臘過的香腸|臘腸
臘過|臘
臟話|爛口
臥具|被鋪
臥|卧
臥底|放蛇
臨時人員|咖哩啡
臨時|吊起手
臨時廚房幫工|幫廚
臨時抱佛腳|臨急抱佛腳
臨時演員|臨記演員
臨時頂替做事|頂檔
臨死前喘氣|牽氣
臨產|作動
臨窗的位置|窗口位
臨陣退縮|縮沙
自以為了不起|讕得戚
自以為很了不起|讕有寶
自以為很內行|讕在行
自以為很|爛
自以為很聰明|讕惺
自以為是|讕在行
自以為有威風|讕得戚
自以為有本事|讕有嘢
自以為有能耐|讕叻
自以為漂亮|唔信鏡
自以為聰明|讕醒
自以為能幹|爛嚦
自以為|讕
自作主張|自把自為
自作多情|表錯情
自作聰明|讕㔹
自來水兒筆|銅筆
自來水|水喉水
自來水筆|水筆
自來水管|水喉
自來水開關|水喉掣
自來狗|飛來蜢
自信十足|信心爆棚
自刎|割頸
自助餐聚會|大食會
自助餐|蒲飛
自動照相機|傻瓜機
自動鉛筆|鉛蕊筆
自命不凡|好牙䶪
自家養的雞|家欄雞
自尋死路|作死
自己人|自己友
自己出錢|挖荷包
自己去撞牆|扻頭埋牆
自己拿主意|自斟自飲
自己最瞭解自己|自己最知自己事
自己洋洋得意|讕得敕
自己洩露|自爆
自己流出來|瀉
自己謙稱|細佬
自己贊成|自彈自唱
自恃內行|讕在行
自恃有本事|讕有嘢
自我介紹|自介
自我炫耀|沙塵
自找倒霉|唔衰搵嚟衰
自找|揾嚟搞
自找辛苦|搵嚟辛苦
自找麻煩|抓蟲入屎胐
自排|自動波
自暴自棄|爛躂躂
自然是|梗係
自然而然|自不然
自然|自不然
自私|縮骨
自私自利|知微麻利
自立|出身
自經|掛臘鴨
自縊|掛臘鴨
自行公開|自爆
自行其是|自把自為
自行車|單車
自行車小徑|單車徑
自行車路|單車徑
自行車道|單車徑
自視甚高|牙擦
自視過高|看高
自覺|覺醒
自誇|口響
自誇命運好|曬命
自高自大|牙擦
自高身價|起市
自鳴得意|讕得戚
臭不可聞|冤崩爛臭
臭史|蘇州屎
臭吹|飽死
臭哄哄|蔫崩爛臭
臭棋|屎棋
臭氣沖天|葾崩爛臭
臭氣熏天|冤崩爛臭
臭氣薰天|葾崩爛臭
臭氣衝天|臭崩天
臭烘烘|臭崩崩
臭美|飽死
臭脾氣|臭品
臭蛋|涴蛋
臭蟲|木蝨
臭阿飛|臭飛
臭顯|白霍
臭|餲
至|嚟
至於|至到
臺|台
臺階|梯級
舀子|殼
舀|抔
舀湯|拂湯
舂米用的木杵|舂杵
舅奶奶|妗婆
舅姥姥|妗婆
舅媽|妗母
舅母|妗母
舅父|舅舅
舅爺|舅公
舅舅|阿舅
與世隔絕|斷六親
與人為善|好相與
與人結仇|招人仇口
與你相約|約定你
與|同
與情人分手|甩拖
與戀人決絕|斬纜
與有關|關
與無關|唔關事
與眾不同|與別不同
興師動眾地找|打鑼噉搵
興師動眾|大陣仗
興旺|旺相
興|行
興起|慶起
興趣|癮
興隆|風生水起
興風作浪|攪風攪雨
舉一反三|話頭醒尾
舉上不靈|論盡
舉止不靈活|笨鈍
舉止|動靜
舉止造作|敦款
舉薦|薦
舉行|做
舉起|擔
舊俗|賣水
舊存貨|倉底貨
舊式的車|老爺車
舊房子|唐樓
舊時稱戲劇演員|戲子佬
舊時罵婦女用|屙尿唔上壁
舊時|舊底
舊衣服|故衣
舊貨|夜冷貨
舊金山|三藩市
舊|陳皮
舌頭|脷
舐|斂
舒暢愉快的感受|梳芙
舒服|精神
舒適|安樂
舔|斂
舖子|舖頭
舞女|舞小姐
舞獅|采青
舞衣|歌衫
航天飛機|太空穿梭機
般|咁
般配|合襯
舵工|艄公
舵|舦
船家|艇家
船狀葯碾|研船
船纜|纜
船費|水腳
良心|本心
艱辛地捱日子的人|馬命
艱辛|鹹苦
色子|雞
色彩斑斕|七彩
色彩斑駁|花哩碌
色彩繽紛|七彩
色情影片|鹹片
色情成分|鹽花
色情營業場所|黃色架步
色情狂|鹹蟲
色情|鹹濕
色拉|沙律
色漆|大油
色澤|色水
色澤黯淡|啞色
色胚|鹹溼佬
色鬼|鹹濕佬
艸部|草花頭
芋頭|檳榔芋
芡粉|生粉
芥末|芥辣
芥末醬|芥辣
芥蒂|計帶
芥藍菜|芥蘭
芥黃|芥辣
芫茜荽|芫荽蔥
芫荽|蒝荽
芭蕉|大蕉
芮氏|黎克特制
芯心|炮仗引
花中之王|花王
花了錢還受罪|貼錢買難受
花俏|花弗
花兒把式|花王
花兒|花
花別針|扣針
花匠|花王
花哩胡哨|花哩碌
花崗岩腦袋|石屎頭腦
花崗岩|麻石
花招兒|噱頭
花招|花臣
花旦腔|子喉
花束|束花
花枝招展|彩雀
花椰菜|椰菜
花樣|花款
花灑|澆花壺
花炮|炮
花生油|生油
花盆底鞋|單齒鞋
花色一樣|同花
花色品種|花款
花色|花款
花花公子|花心蘿蔔
花花|化化聲
花花綠綠|花碌碌
花莖甘藍|芥蘭
花蕾|花冧
花言巧語|一輪嘴
花費不多|花費冇幾
花費的錢款|皮費
花費|皮
花轎|大紅花轎
花邊|八卦
花里胡哨|花哩碌
花銷|支繃
花錢|使錢
花錢大手大腳|手疏
花錢如流水|大使
花錢找罪受|貼錢買難受
花錢無度|荷包亂揈
花錢買罪受|貼錢買難受
花面|花面貓
苗條|瀟湘
苛刻待人|剋治
苛刻|腌尖
苛待|治
苛求|腌尖腥悶
苤藍|芥藍頭
若干|好幾
若是|若果
苦力|咕喱
苦日子|鹹苦
苦澀|劫
苦熬日子|挨生挨死
苦瓜|涼瓜
苦苦哀求|㥋㥋𧬊𧬊
苯手苯腳|論盡
英國人|英國佬
英文|雞腸
英泥|紅毛泥
英語課|英文堂
英里|咪
茄子的一種|荷包茄
茄子|矮瓜
茅利塔尼亞|毛里塔尼亞
茅坑兒|屎坑
茅屋|茅寮
茅廬|茅寮
茅房|屎坑
茅棚|茅寮
茅舍|茅寮
茅草根|茅根
茅香|臭草
茡薺|馬蹄
茭白|茭筍
茶具|茶杯碟
茶樓|居
茶樓飯店的伙計|徛堂
茶樹籽|茶仔
茶水|茶
茶盅|焗盅
茶食|茶果
茶館|茶居
茶點|點心
茹素|打齋
茼蒿|唐蒿
草地|草地皮
草坪|草皮
草字頭兒|草花頭
草字頭|草花頭
草木茂盛|蘙
草率|咿咿呶呶
草草|沙沙滾
草莓|士多啤梨
草藥|山草藥
草蜥|草龍
草頭兒|草花頭
草魚|鯇魚
荒廢|丟生
荒疏|丟疏
荒謬|譅戇
荔枝佳品之一|桂味
荷巴特|霍巴特
荷蘭豆仁|豆仁
荸薺|馬蹄
荼毒|教壞
莊稼漢|耕田佬
莖|框
莫三比克|莫桑比克
莫名其妙|一頭霧水
莫逆之交|死黨
莫非|唔通
菜名|苦麥菜
菜嫩|嫩口
菜市場|街市
菜幫|菜莢
菜棧|菜欄
菜牌|水牌
菜籽|菜仁
菜肴製作法|鑲
菜肴類|鹹淡
菜花|椰菜花
菜薹|菜心樖
菜豆|四季豆
菜豌豆|荷蘭豆
菜餚豐富|九大簋
菜餚|餸
華人|唐人
華夫|威化餅
華而不實|花巧
菰筍|茭筍
菲律賓傭人|賓妹
菲律賓籍女傭人|菲傭
菲藉傭人|菲傭
萬事通|通天曉
萬人仰慕|萬人迷
萬人著迷|萬人迷
萬料不到|勢估唔到
萬|皮
萬能鑰匙|百合匙
萬遇想不到|勢想不到
萬那杜|瓦努阿圖
落地燈|座地燈
落地電扇|座地風扇
落後|執輸
落後於人|執輸
落|拉
落枕|戾頸
落水狗|耷尾狗
落湯雞|濕水雞
落潮|水退
落空|衰
落色兒|甩色
落附在|褸
落降|落降頭
落音|歇聲
落魄|阿哩吉諦
葉門|也門
著名粵菜|冬瓜盅
著名餅食|西樵大餅
著急|喉急
著涼|凍親
著火|火燭
著色|上色
葛摩|科摩羅
葡萄乾|葡提子乾
葡萄|提子
董事|老細
董事長|老細
葫蘆|俘虜
葯片|藥餅
葵樹葉扇子|葵扇
葵花子|葵瓜子
葷油|豬膏
葷食|雜
蒙|摟
蒙特內哥羅|黑山
蒙特婁|蒙特利爾
蒙羞|羞人
蒙蒙亮|曚曚光
蒙蓋|壅
蒲扇|葵扇
蒲隆地|布隆迪
蒸米粉卷兒|腸粉
蒸餾水|倒汗水
蒼蠅|烏蠅
蒿子稈兒|塘蒿
蓉|茸
蓋亞那|圭亞那
蓋住|罯住
蓋大樓|起高樓
蓋好蓋子|罯好個蓋
蓋|弇
蓋房子|起屋
蓋澆飯|碗頭飯
蓋碗兒|焗盅
蓋碗|焗盅
蓋章|搨印
蓋菜|大芥菜
蓋著|笠住
蓋被|冚被
蓋造房子|起屋
蓋過|冚過
蓬蒿|唐蒿
蓮花白|椰菜
蓮花的地下莖|藕
蓮蓬頭|花灑
蓮霧|天桃
蔑視|睇衰
蔫壞|陰濕
蔬菜批發市場|菜欄
蔬菜批發店|菜欄
蔬菜的中心部分|菜膽
蔬菜|菜蔬
蕉類果實|蕉
蕩婦|姣婆
蕹菜|通菜
蕺菜|魚腥草
蕾絲|籬士
薄乎乎|薄切切
薄呢子|薄絨
薄情|逆情
薄煎餅|班戟
薄益益|薄英英
薄薄的|薄設設
薄|薄身
薏仁米|薏米
薏苡|薏米
薑泥|薑蓉
薑酌|薑酒
薤菜頭|蕎頭
薤|蕎頭
薩克斯管|色士風
薩克斯風|色士風
薩其馬|馬仔
薪水|份人工
薪水工資|糧
薪金|人工
薯蕷|淮山
薯類|薯
藉口|借頭借路
藉故推搪|支支坐坐
藉神騙錢者|神棍
藉端|借頭借路
藍色|青
藏|匿
藏在|揞喺
藏蒙哥兒|捉兒人
藏貓兒|伏匿匿
藏起來|收埋
藏頭露尾|縮骨
藕尾|藕筒
藕|蓮藕
藤器具|藤笭
藤子|藤
藤藤菜|通心菜
藤鞭子|藤條
藥丸|丸仔
藥丸狀的毒品|丸仔
藥引子|引
藥物|藥
藥碾子|研船
蘆穄|高粱粟
蘇伊士|蘇彝士
蘇利南|蘇里南
蘇打|梳打
蘇打餅乾|克力架
蘸墨水的鋼筆|墨水筆
蘿蔔乾兒|菜脯
蘿蔔乾|菜脯
蘿蔔糠了|花心蘿蔔
虎頭蛇尾|有頭冇尾
虐待|作賤
虐待動物|虐畜
虔誠|神心
處在|喺埋
處女雞|雞項
處|度
處所|碇
處方箋|醫生紙
處理屍體|執屍
處理|辦
處處針對|窒頭窒勢
虛假|花假
虛偽的客氣|讕客氣
虛偽|花假
虛寒|寒底
虛弱|孱
虛張聲勢|拋浪頭
虛有其表|花巧
虛汗|淡汗
虛誇的話|大話
號兒|籌
號|碼
號碼|冧巴
號碼牌|籌
號碼鎖|字鎖
號脈|探脈
虧待|待薄
虧得|難為
虧心事|陰質事
虧本兒|蝕底
虧本|蝕底
虧欠|負
虼子|狗虱
蚤|狗虱
蚯蚓|黃䘆
蚱蜢|草蜢
蚶子|泥蚶
蛀書蟲|書蟲
蛀蟲|蠹蟲
蛇蛻|蛇脫
蛇鯔|狗棍
蛋塔|蛋撻
蛋捲兒|蛋捲
蛋|春
蛋糕|戟
蛋羹|水蛋
蛐蛐|蟀
蛐親|黃犬
蛤蜊油|雪蛤膏
蛤蟆油|田雞油
蛸|八爪魚
蛻|蜕
蜀黍|高粱粟
蜂巢胃|蜂肚
蜂巢|蜜蜂竇
蜂窩|蜜蜂竇
蜂蜜|蜜糖
蜂蠟|蜜蠟
蜇|針
蜈蚣|百足
蜘蛛|蠄蟧
蜜餞李子|嘉應子
蜢|草蜢
蜷縮|思思縮縮
蜻蜓|塘蝞
蝎虎子|鹽蛇
蝙蝠|飛鼠
蝦米|蝦公
蝦|蝦公
蝦蟆的胃|釦
蝦醬|鹹蝦
蝸局|白鴿籠
蝸牛|東風螺
螃蟹殼|蟹蓋
螃蟹|蟛蜞
螞螂|螗蝞
螞蟥|蟥蜞
螞蟻在爬|蟻躝
螞蟻|蟻
螢幕|熒幕
螢火蟲|放光蟲
螫|針
螯|剛
螺口甲|厴
螺帽|絲帽
螺旋槳|車葉
螺母|絲母
螺絲刀|螺絲批
螺絲帽|絲帽
螺絲母|螺帽
螺絲起子|螺絲批
螺絲|鏍絲
螺螄|石螺
蟋蟀|織蟀
蟑螂|曱甴
蟒蛇|蝻蛇
蟬的殼|蟬蛻
蟬|秋蟬
蟲膠漆|士叻
蟹子|蟹春
蟹臍甲|厴
蟹臍|蟹厴
蟹螯|蟹弶
蟹鉗|蟹弶
蟹黃|蟹膏
蟾蜍|蛤乸
蠅子|烏蠅
蠕動|蜎
蠟扞兒|香案
蠟扦兒|手照
蠟燭|洋燭
蠢人|豬頭
蠢笨者|豬八
蠢笨|薯頭
蠢豬|豬嘜
蠢貨|茂尼
蠢鈍|豬兜
蠶卵|蠶春
蠶的幼蟲|蠶蟲
蠶蛹|蠶蟲
蠶|蠶蟲
蠻不講理|蠻橫
蠻勁兒|蠻力
蠻可愛|幾可愛
蠻幹|監粗嚟
蠻橫戾乖|戾橫折曲
蠻橫無理|打橫嚟
蠻橫|蠻
蠻|頗為
血管爆裂|爆血管
血|紅
血絲|紅筋
血豆腐|豬紅
行不通|唔撈
行乞|揸篼
行事不當|屙尿遞草紙
行人穿越道|行人過路綫
行人|途人
行劫|打劫
行動不便|論盡
行動|做嘢
行動寬頻|流動寬頻
行動慌張的人|失魂魚
行動數據|流動數據
行動笨拙|番薯
行動自如|行得走得
行動裝置|流動通訊器材
行動詭秘|鬼頭鬼路
行動通訊|流動通訊
行動電話|手提電話
行家|熟行
行時|當時得令
行李箱|車尾箱
行業|行頭
行為粗賤|匪類
行為詭秘者|攝青鬼
行當|瓣
行規|架步
行蹤不定|攝青鬼
行軍水壺|水壺
行黑路|行斜路
術士|南無佬
街上的水管|街喉
街上|街邊
街上賣熟食的小攤檔|熟食檔
街坊鄰居|街坊街里
街坊里道|街坊鬼鬼
街坊|隔籬鄰舍
街心小花園|花圈
街道上|街路
街里街坊|街坊鬼鬼
街頭廣告|街招
街頭|街口
街頭訪問|街訪
衛生棉|衛生巾
衛生球|臭丸
衛生紙|廁紙
衛生衣|波恤
衛|衞
衝浪|滑浪
衝突|嗌霎
衝著頭|兜頭
衝進|衝入
衣兜|衫袋
衣剪|洋剪
衣字旁兒|禮衣邊
衣字旁|禮衣邊
衣服上的霉點|墨屎
衣服下擺|衫尾
衣服下襬|衫腳
衣服墊肩|假膊
衣服後擺|衫尾
衣服接縫處|骨
衣服的總稱|衫褲
衣服的裏子|衫裏
衣服|衫
衣架|衫架
衣物等的內層|襯裏
衣物|衫褲
衣着打扮光鮮|好色水
衣着打扮|色水
衣箱|櫳
衣索比亞|埃塞俄比亞
衣著不整|離氣
衣著整潔好看|光鮮
衣衫襤褸|褸丘
衣袖|衫袖
衣補兒|禮衣邊
衣裳|衫褲
衣襬|衫尾
衣角|衫尾
衣領|衫領
衣食無憂|唔憂柴又唔憂米
衣食父母|米飯班主
表兄弟|老表
表單|表格
表姐妹|老表
表完成|起
表情|口面
表情呆板|木獨
表情呆滯|木獨
表明|告
表演一下|拋下
表演|騷
表示好不容易才|幾難先至
表面不平整|一岩一窟
表面皺|巢皮
表面起皺紋|巢皮
衹|剩係
衹是|淨係
衹有|惟有
袋子|袋
袋泡茶|茶包
袒護|爭
袖兒|衫袖
袖口上的貼邊|袖口貼
袖口|袖邊
袖套|手袖
袖子|袖
袖手旁觀|繑起雙手
袖扣兒|袖口紐
袖章|臂章
被人作弄|炖冬菇
被人打敗|打輸
被傳染|惹
被出賣的人|豬仔
被利用者|過河卒
被問題難住了|問起
被嚇住|窒
被套|被袋
被子|張被
被扣押|扮蟹
被捆綁|扮蟹
被捉弄的人|老襯
被搔癢的感覺|肉酸
被槍斃|背脊開窿
被水淹沒|水浸
被牽連|拖落水
被|畀
被窩兒|被竇
被窩|被竇
被絞決|問吊
被綁架的事主|肉參
被罩|被袋
被罰停賽|坐波監
被胎|棉胎
被處絞刑|問吊
被裏|被單
被褥|被鋪
被解僱|食冇情雞
被解顧|執包袱
被訓斥|食貓麵
被趕到絕路|迫到盡頭之中
被迫|局住
裁|刉
裁判|公證
裁判員|球証
裂紋|裂
裂縫|窿罅
裂開口子|哆
裂開|爆
裏出外進|岩岩巉巉
裏外不是人|做磨心
裏子|裏
裏邊兒|裏頭
裏邊|入面
裏面|入面
裏頭|入便
裙子|裙
裙帶仔|裙腳仔
補丁|補掩
補上欠的人情|補數
補償|補數
補摺|打簿
補救|執生
補救起來|兜返住
補習班|補習社
補|補數
補貼|罯
裝作看不見|冇眼屎乾淨盲
裝傻充愣|詐癲扮傻
裝傻|扮傻
裝傻裝愚笨|詐呆詐吽
裝入|入
裝入袋中|袋
裝卸貨物|起落貨
裝在|袋喺
裝好人|扮好人
裝富|充大頭鬼
裝扮|姿整
裝模作樣地叫|鬼聲鬼氣
裝模作樣|整色整水
裝模做樣|整古做怪
裝模裝樣|詐詐諦諦
裝樣子|整色水
裝瘋賣傻|詐癲扮傻
裝相片的鏡框|相架
裝神弄鬼|整蠱做怪
裝置|設備
裝聾作啞|詐聾扮啞
裝著熟悉的樣子|讕熟落
裝蒜|詐諦
裝訂|訂裝
裝貨|起貨
裝載|載
裝門面|整色水
裝闊|充大頭鬼
裝闊氣|充大頭鬼
裝鬼臉|整鬼整馬
裝點|擺
裡|度
裡邊兒|入便
裡邊|入邊
裡面|入面
裸露|冇遮冇掩
裸露出|打出
裸體照片|寫真
裹|纏
裹脊|柳
裹腳布|腳帶
製作|整
製作菜肴|煮菜
製冷劑|雪種
製模具|倒模
製造事端者|攪屎棍
製造|整
製造是非者|是非竇
製造氣氛|搞氣氛
製造聲勢|造勢
製造麻煩的人|煩友
製|釀
複印|影印
複寫紙的舊稱|留底紙
複寫紙|過底紙
複習功課|溫功課
複習好了|溫熟
褐色|豬肝色
褐雲瑪瑙螺|東風螺
褓姆|湊仔婆
褥子|墊褥
褪套兒|縮沙
褪色|甩色
褯子|尿片
褲子口袋兒|褲袋
褲子拉鎖兒|褲鍊
褲子拉鏈兒|褲鍊
褲子|褲
褲帶|褲頭帶
褲管很窄的褲子|臘腸褲
褲腰|褲頭
褲腿的下端|褲腳
褲腿|褲髀
褲衩兒|短褲
褲衩|褲頭
褶子|褶
襪口|襪頭
襪子|襪
襪帶|襪箍
襯底|打底
襯衣|恤衫
襯衫|恤衫
襯裏|裏
襯裙|底裙
襯褲|底褲
襲擊警察|襲警
西式糕餅|西餅
西式糕點|西餅
西式香腸|紅腸
西方人|西人
西方電影|西片
西曬|西斜
西服|西裝
西洋人|西人
西洋參|花旗參
西洋小孩|番鬼仔
西洋年輕女性|番鬼妹
西洋旱芹|西芹
西洋景|西洋鏡
西洋梨|啤梨
西洋棋|國際象棋
西洋|番鬼
西洋芹菜|西芹
西番蓮果|雞蛋果
西紅柿汁|茄汁
西紅柿醬|茄醬
西芹菜|西芹
西菜|西洋菜
西裝畢挺|西裝骨骨
西裝|老西
西裝革履|西裝骨骨
西谷米|西米
西餐|西菜
西點|西餅
要上廁所|人有三急
要不|唔係嘅話
要不得|唔要得
要不然|一唔係
要人|猛人
要人的命|收買人命
要修補|要修要補
要修讀|要讀
要做|事幹
要價太高|食水太深
要命|交關
要嘴兒|嘬嘴
要好|老友
要完蛋|凍過水
要小便的感覺|尿急急
要我好|想我好
要打要殺|打打殺殺
要是|若果
要死|死死下
要死要活|喊生喊死
要求大|開胃
要求高|眼角高
要生要死|喊生喊死
要算|可算
要緊|緊要
要美|貪靚
要買就要快|有買趁手
要趣|貪得意
要錢|磅水
要錢要得太狠|食水深
要面子|要面
要飯|揸篼
要麼|一係
覆|弇
覆蓋|弇
見不了人|唔見得人
見不得人的事|鬼馬事
見便宜就搶|好食爭崩頭
見效|見功
見斤兩|重秤
見笑|笑話
見解|睇法
見誰學誰|有樣學樣
見識一下|見識下
見識不多|未見過大蛇屙屎
見識|眼界
見錢眼開|見錢開眼
見面|會面
見面的小禮物|手信
見風轉舵|趁風使𢃇
規則|例規
規定|定
規定時限|限時限刻
規格|晒士
規模小|蚊型
規矩|規例
覓食|搵食
視力不佳|冇眼界
視力不好|唔夠眼
視力好|好眼界
視力|眼水
視物矇矇矓矓|眼矇矇
視訊|視像
親人的靈牌|神主牌
親吻|咀嘴
親嘴兒|嘬嘴
親嘴|啜嘴
親姐姐|家姐
親家公|親家老爺
親家母|親家奶奶
親家|老親
親密合作|同撈同煲
親密無間|糖黐豆
親戚之間|親戚鬼鬼
親戚朋友|親朋戚友
親手|一手一腳
親朋好友|親朋戚友
親熱|埋身
親自動手|親手
親自幹|親力親為
親自目睹|親眼
親自|親
親自說|親口
親近|和揖
覬覦|猴
覺察|醒水
覺得|覺到
觀其物可以知其人|物似主人形
觀看|捧場
觀賞傳統戲劇|睇大戲
觀賞戲劇|睇戲
角色湊齊|夠腳
角落|旮旯
解不了渴|唔夠喉
解僱信|大信封
解僱|炒魷魚
解散|散水
解暑的藥茶|涼茶
解析度|解像度
解決|搞直
解簽|拆簽
解籤|詳簽
解說|旁述
解釋|解
解除|解
解餓|頂肚餓
解饞|口痕
觸|掂
觸摸|掂
言出傷人|臭口
言歸於好|箍煲
言而無信|冇口齒
言行荒唐|譅戇
言語不通|雞同鴨講
言語|說話
言語輕佻|口花花
言談自負|牙擦
訂位|卡位
訂單|柯打
訂得高一點|定高一點
訂|柯打
計劃|劃
計畫|計劃
計程車|的士
計策|計仔
計算器|計數機
計算好|算好
計算|計數
計謀多|多計
計謀|橋架
計較|拘執
訊息|口訊
訊餅|曲奇
討人厭|犯眾憎
討人喜歡|趣怪
討人嫌|乞人憎
討便宜|搵著數
討價|講數
討價還價|講數口
討厭|憎
討厭的女人|衰婆
討厭鬼|衰公
討回面子|執看身彩
討好|賣面光
討生活|揾食
討錢|乞錢
討飯三年懶做官|做慣乞兒懶做官
討飯|乞食
訓了一頓|㨘到爉爉令
訓練|操
記事本|記事簿
記住|認住
記性不好|大頭蝦
記性差|冇記性
記性|耳性
記憶力差|冇記性
記憶|記
記|胎痣
記號|色認
記錄下來|錄得
記錄在手冊裏|寫手冊
記錄|錄得
訟師|師爺
設你入局|氹你入局
設圈套使人上當|裝
設圈套|裝彈弓
設宴|擺酒
設想|所諗
設法陷害|煮
設陷阱|放蛇
許多人|眾
許多債|一身債
許多時候|很多時
許多|眾
訴苦|呻
訴訟律師|大律師
訴訟費|堂費
診斷證明書|醫生紙
診斷錯誤|斷錯症
診治|睇症
診病|睇病
診脈|把脈
註冊|開戶
詐騙為生|靠𧥺
詐騙|𧥺騙
評測|跑分
評論|評價
評頭品足|指指彈彈
詞彙|詞匯
詢問|問
試吃|試食
試工的俗稱|試飯碗
試探|探盤
試樣|板
試用碟|試玩碟
試穿|試身
試著|嘗試
試衣服|試身
試試看|試下
試試|試下
試試運氣|撞手神
試頭水兒|飲頭啖湯
詭計多端|詭譎
話不投機|九唔搭八
話中有話|講話有骨
話又說回來，|話時話，
話多的人|口痕友
話多|贅氣
話筒|咪
話語|時文
話說得多|譅
話說得好聽|好口
話|說話
話音未落|話口未完
該怎麼辦|點算好
該打|抵打
該|抵
該挨打了|腰骨痕
該搧|抵摑
詳細|詳細
詼諧|生鬼
詼諧而生動|生鬼
誇下海口|爆響口
誇口|牙擦
誇大|作大
誇張|葳蕤
誇獎|褒獎
誇耀|讚
誇誇其談|指天擉地
誇贊|褒獎
認乾親|上契
認可|認同
認定|睇死
認得|識得
認為|話
認真|畀心機
認真點|正經啲
認著|認住
認識|識得
認賬|擔認
認輸|認低威
認道|識得
認錯|低威
誓死|死個
誘人|惹火
語境|前文後理
語無倫次|窒口窒舌
語言|話
誠實|老實
誠心|神心
誣賴|戾
誣陷|冤戾
誤事|害死
誤入歧途|行差踏錯
誤|害死
誤會|會錯意
誤解|搭錯綫
誤診|斷錯症
誤踹|蹅
誤點|過鐘
說一不二|話一就一、話二就二
說一套做一套|講一套做一套
說一是一、說二是二|話一就一、話二就二
說三道四|噏三噏四
說不停|多事實
說不定|話唔埋
說不準|話唔定
說不該說的話|多聲
說不過|不夠
說了不算|冇口齒
說了不認賬|賴貓
說了半天|講極
說了算|話事
說了話不算|口輕
說人不明道理|讀枉書
說人怕冷|發貓寒
說人輕賤|賤骨頭
說個不停|雞啄唔斷
說假話|講假
說出來|說出
說到底|話晒
說到最後|說到尾
說到|說開
說句不好聽|好話唔好聽
說啥也不行|乜都假
說夢話|發開口夢
說大話不交稅|吹水唔抹嘴
說好聽的話|賣口乖
說好話|幫下口
說定|講實
說實話|講真
說對了|話中
說幾句話|講幾句說話
說廢話|講耶穌
說得天花亂墜|口響
說得好聽|講得口響
說得這麼容易|話咁易
說得過去|就話
說得難聽一點|好話唔好聽
說悄悄話|傾密蓋
說故事|講古仔
說教|講耶穌
說明|解明
說時遲、那時快|話都冇咁快
說書|講古
說服|冧到
說某人的壞話|煮重米
說氣話|發晦氣
說沒影兒的事|煲冇米粥
說渾話|發開口夢
說漏了嘴|漏口風
說玩笑話|講假
說的和做的完全兩樣|講一套做一套
說真的|講真
說瞎話兒|講大話
說瞎話|講大話
說破了嘴|講極
說笑話|講笑
說笑|講笑
說粗話|講粗口
說著玩|貪口爽
說|話
說話不乾淨|粗口
說話不含蓄|露骨
說話不對頭|口臭
說話不流利|吃口吃舌
說話不知輕重|下巴輕輕
說話不算數|紙扎下巴
說話不負責任|下爬輕輕
說話含糊|食螺螄
說話快|急急口
說話滿口髒字|粗口爛舌
說話算話|講過算數
說話粗俗下流|粗口爛舌
說話結巴的人|留口佬
說話結巴|礙口
說話|講嘢
說話雜亂|係乜係物
說說而已|口爽爽
說謊|講大話
說起來不順口|咬口
說起來|講開
說起|說開
說過便算|下爬輕輕
說錯話|噏着脷
說風涼話|好唱口
說騙局不可能持久|風水佬唔呃得十年八年
說髒話|講粗口
誰也不欠誰|冇拖冇欠
誰也不認識誰|三九唔識七
誰料到|點知
誰料得到|誰不知
誰料|點知
誰知道|點知
誰知|點知
誰|邊位
課|堂
課堂|課室
調味品一種|醬
調味料|味
調味|校味
調味醬一種|柱侯醬
調唆擺佈|唆擺
調好|校好
調對|校
調戲|非禮
調換|換轉
調整|整
調皮搗蛋|星君
調皮搗蛋的小伙子|笭仔
調皮|百厭
調皮者|星君友
調皮鬼|娃鬼
調羹|匙羹
調職|過檔
調較|校
調配|校
調頭寸|撲水
談不上攏|雞同鴨講
談不來|傾唔埋
談不攏|傾唔掂數
談判|講數
談天|傾蓋
談好|傾掂
談妥|斟妥
談妥條件|傾掂數
談很久電話|煲電話粥
談得來|傾得埋
談心|講心事
談戀愛|拍拖
談條件|詏數
談私房話|密斟
談話|傾蓋
談談|傾下
請人代筆|請槍
請人捉刀|請槍
請人槍替|請槍
請你|唔該
請假|攞假
請別見怪|有怪莫怪
請勿|唔好
請吃喜糖|請食糖
請吃喜酒|請飲
請吃宴席|請飲
請|唔該
請喝喜酒|請飲
請客吃飯|請飲茶
請帖|紅色炸彈
請慢用|靡靡食
請教|唔該
請讓一讓|借借
請讓讓|借歪
請進|請入
諧趣電影|笑片
諮詢電話|熱線電話
諷刺|譠打
諸事不順|行步路打倒褪
諸位|咁多位
諾魯|瑙魯
謀生|搵食
謀生的方法|米路
謂千真萬確|珍珠都冇咁真
謂容易辦|好閑
謊言|大話
謊話|大話
謎語|古
謙虛|謙厚
謙遜|謙
講信用|牙齒當金使
講信義|君真
講|傾
講價錢|講數口
講到底|假假地
講故事|講古仔
講條件|講數口
講求|講
講清楚|話明
講玩|講笑
講究信用|講口齒
講究喝酒的人|飲家
講究飲食|會飲會食
講究|骨子
講者|講員
講解|講書
講評|評講
講話|講說話
講課|講書
講道理|講耶穌
講閑話|學是非
講閒話|學是非
謝|唔該
謝神|酬神
謝謝|唔該
謝謝關心|有心
謹言|密實
證件|紙
證據|理據
證明書|沙紙
證明|證
證書|沙紙
譏彈|唱衰
譏笑人家長得醜|畫壞鐘馗
識別好壞人|帶眼識人
識別好壞|帶眼識人
識別|記認
識破|識穿
識趣|通氣
譜兒|度數
警句|金句
警員|差人
警官|沙展
警察局|警署
警察|阿蛇
警笛|銀雞
警署|差館
警覺|醒水
警醒|鬼打咁醒
警長|沙展
譬如說|比如話
議價|講數
議論|唱衰
護墻|壆
護士|姑娘
護著|幫住
讀了|讀過
讀|入讀
讀死書|唸口簧
讀起來不順口|詏口
變動|郁動
變化無常|午時花六時變
變卦|縮沙
變味|䭞
變壓器|火牛
變差|走下坡
變形|𥁒
變得興盛|發達
變成|搞到
變戲法|敕法
變扁|癟
變更|更改
變瘦|落形
變紅|紅
變色|轉色
變速擋|波
變速杆|波棍
變速箱|波箱
變魔術|出把戲
變黏|起膠
讓一讓|借一借
讓人上當吃虧|搵老襯
讓人|令人
讓人吃驚|令人驚
讓人當冤大頭|搵老襯
讓你一塊來玩|摻埋你玩
讓我|畀我
讓|等
讓開|借歪
讚揚|讚
豁亮|光猛
豁出去了|幾大就幾大
豁出命|打死罷就
豁唇的人|阿崩
豁嘴兒|崩口
豁嘴|崩口
豆乳|豆奶
豆乾兒|豆腐潤
豆乾|豆潤
豆子|白豆
豆子的皮|豆衣
豆油燈|燈盞
豆泥|豆茸
豆漿|豆奶
豆瓣菜|西洋菜
豆瓣醬|麵豉
豆粉|生粉
豆腐乾兒|豆腐潤
豆腐乾|豆潤
豆腐皮|豆皮
豆腐腦兒|豆腐花
豆腐腦|豆腐花
豆花|豆腐花
豆芽兒|芽菜
豆芽菜|芽菜
豆薯|沙葛
豆角|麥豆
豆豉汁|豉汁
豇豆|豆角
豈只|點止
豈有此理|可嬲嘢
豌豆|麥豆
豎向的平行條紋|柳條
豎心旁|穿心邊
豎直|戙企
豎着|打掂
豎立|戙徛
豎|竪
豎起|棟起
豐乳|隆胸
豐年|大造
豚蹄|圓蹄
豚鼠|葵鼠
象棋術語|過河卒
象皮魚|剝皮牛
象鼻子|象拔
豪爽|大手筆
豪華裝修|豪裝
豪豬|箭豬
豬下水|豬雜
豬內臟的一分|豬上雜
豬內臟的統稱|豬雜
豬前腿|豬手
豬圈|豬欄
豬後肢|豬腳
豬後腿|豬腳
豬排|豬扒
豬柳|脢柳
豬油|豬膏
豬牛等的肉|紅肉
豬病的一種|豬疔
豬的前蹄|豬手
豬的大腸|豬大腸
豬的後蹄|豬腳
豬的肋骨|豬排骨
豬的胃|豬肚
豬的頭骨|豬頭骨
豬的骨髓|豬骨髓
豬皮油|豬膏
豬窩|豬竇
豬羊牛的脊部肉|柳肉
豬肘子|豬㬹
豬肝|豬潤
豬脊椎骨|龍骨
豬腎臟|豬腰
豬腮部的肉|豬兜肉
豬腰子|豬腰
豬腳|豬手
豬腳醋|豬腳薑
豬腸粉|腸粉
豬腹部的五花肉|腩頭
豬膽|貓藥
豬臀肉|沙梨豚
豬舌|豬脷
豬血|豬紅
豬|豬隻
豬蹄子|豬腳
豬蹄|豬腳
豬雜碎|豬雜
豬頭部的肉|豬頭肉
豬頰肉|豬兜肉
豬鬃|豬鬃毛
豬鼻子|豬坌鼻
貌醜之人|豬八怪
貌醜|醜人
貓兒|貓
貓吃食的盆子|貓兜
貓腰|烏低身
貓身上的跳蚤|貓蝨
貝克漢|碧咸
貝南|貝寧
貝殼|蜆殼
貝里斯|伯利兹
負|佗
負心|反骨
負總責|擔綱
負責人|阿頭
負責|擔帶
財主|闊佬
財力雄厚|財雄勢大
財大氣粗|財雄勢大
財富|身家
財東|老細
財源滾滾|豬籠入水
財產|身家
財迷心竅|發錢寒
財運|財氣
財雄勢強的人|大鱷
貢獻|出糧
貧嘴|吱喳
貧嘴的人|口痕友
貧嘴薄舌|口花花
貧窮|唔得掂
貨幣貶值|折水
貨攤|檔攤
貨樣|辦
貨物標出價錢|開盤
貨物樣品|貨辦
貨物脫銷|斷市
貨物|貨仔
貨真價實|平靚正
貨腳|運腳
貨舶來品|嚟路嘢
貨色|貨仔
貨車的拖車|拖卡
販賣報刊|賣報紙
販運貨物者|水客
貪嘴|河流
貪圖之物|貪頭
貪圖身材窈窕|貪瀟湘
貪婪地盯着|眼甘甘
貪婪|婪劣
貪得無厭|大貪
貪心之極|大貪
貪心重|婪劣
貪新鮮|三日香
貪玩好動|冇定性
責任感|擔帶
責備|話
責怪|怪責
貯物室|士多房
貴相|貴氣
貴號|寶號
貴重之物|金牛
貴|重皮
貴重|矜貴
貶低|踩
貶值|縮水
貶損|唱
買下它|買咗佢
買主|僱主
買了|買起
買光|掃晒
買|執
買布|剪布
買燒烤肉食|斬料
買空賣空|炒買炒賣
買米|糴米
買賣不興旺|淡市
買賣|交投
買賣人|生意佬
買賣好|好市
買賣的價格|盤口
買路錢|行水
貸樣|貨辦
費力|抵力
費口舌|勞氣
費工夫|費事
費心|多煩
費心思|霎氣
費時|把鬼
費時間|阻事
費氣|譅氣
費用不多|花費冇幾
費用|皮費
費神|勞氣
費腦子|頭大
費腦筋|頭奅
貼上|粘貼
貼地|塌地
貼本錢|虧本
貼滿|大貼
貼身丫頭|近身妹
貼身的侍從|近身
貼近|貼
貽笑大方|笑話
貽貝|青口
貿然|貿貿然
賀年片|拜年咭
賄買|打色
賄賂之物|背手
資料夾|快勞夾
資料|料
資望不足|唔夠飣
資金周轉不開|劃唔轉
賊匪搶劫店鋪|埋櫃
賊眉鼠眼|蛇頭鼠眼
賊贓|老鼠貨
賒欠|賒住
賓館|酒店
賞小錢兒|打賞
賞臉|畀面
賞賜|打賞
賠了夫人又折兵|貼錢買難受
賠償治傷費|賠湯藥
賠償|賠
賠本兒|折本
賠本|虧負
賠本錢|折本
賣不出去的貨|跳樓貨
賣乖之言|唱口
賣乖|好唱口
賣二水貨|夜冷
賣俏|發姣
賣出|甩手
賣到|賣成
賣剩的貨|水尾嘢
賣力氣|落力
賣力|起勢
賣勁兒|落力
賣勞力的工人|咕哩
賣古玩的商店|古玩鋪
賣報人|報紙佬
賣好|賣面光
賣座|收得
賣廣告|賣告白
賣弄|演嘢
賣弄自己|曬嘢
賣弄風情|放電
賣弄風騷|發姣
賣攤|攤檔
賣方|沽盤
賣熟食|斬料
賣苦力|做驢仔
賣身|包起
賣醬料的店鋪|醬園
賣魚的地方|魚欄
賤貨|衰婆
賤骨頭|賤格
質佳之物|頭啖湯
質佳|靚嘢
質問|質
質地差|二打六
質差|擇使
質次|化學
質素差劣的影片|雞片
質素未符理想|不夠質素
質較好的雜碎|雜
質量佳|家用
質量好|正斗
質量好的東西|正斗嘢
質量差|單薄
質量與價值相稱|物有所值
賬戶|戶口
賬房先生|內櫃
賬|數
賬目|賬
賬號|戶口
賭博|搏殺
賭博攤子|賭檔
賭攤|賭檔
賭東道|輸東道
賭氣|鬥氣
賭花會|買字花
賭足球賽|賭波
賭運氣|博彩
賭馬迷|馬迷
賴|弊
賴數|賴賬
賴比瑞亞|利比里亞
賴皮|奸賴
賴索托|萊索托
賴脹|撻數
賴著不走|賴死
賴著|賴死
賴賬|㒓數
賺大錢|豬籠入水
賺得多|好賺
賺得太狠|食水深
賺錢多|食水深
賺錢|搲銀
賺頭少|奀
購物|買嘢
購置產業|置業
賽普勒斯|賽浦路斯
賽跑|鬥走
賽車|鬥車
賽馬場|馬場
賽馬季節|馬季
賽馬票|馬標
賽龍船|扒龍舟
贈送|送
贊賞者|捧場客
贏|中
贏定|贏硬
贓|砌生豬肉
贖票兒|贖參
赤條條|光脫脫
赤膊|赤肋
赫塞哥維納|黑塞哥维那
赭色|豬肝色
走一步是一步|見步行步
走一步看一步|見步行步
走一轉又回來|打白鴿轉
走不動|拋錨
走之兒|艇仔
走人|拉差
走來走去|兩頭走
走出位子|出位
走到|出到
走到底|行到篤
走動|揗
走各種門路|蜎窿蜎罅
走在一起|行埋
走失|蕩失
走好運|行大運
走廊|冷巷
走得快才是好|行得快、好世界
走得快|雞噉腳
走！|扯！
走明棋|開明車馬
走歪門|行斜路
走水客|水客
走江湖|江湖佬
走漏風聲|漏口風
走為上著|早走早着
走私貨|鹹水貨
走紅運|走紅
走累了|行得累
走纜繩|踩軟索
走背運|運滯
走脫|走雞
走著瞧|睇住嚟
走|行
走街串巷|過街過巷
走起來|行得
走路一扭一扭|踜踜下
走路不看路|行路唔帶眼
走近|行埋
走運了|好彩
走運|行運
走遍|去盡
走過來|行埋嚟
走過頭|過龍
走錯|去錯
走錯路|去錯
走錯門|錯蕩
走門路|搵路
走開|跙
走霉運|行衰運
走馬看花|走馬觀花
赴宴禮服|飲衫
赴湯蹈火|沒水舂牆
起不良之心|起痰
起了貪欲|起心
起作用|晒食
起來|起身
起來！|頂起！
起先|頭頭
起出來|起
起初|初頭
起勁|猛咁
起名兒|安名
起名|改名
起壞心|起痰
起子|螺絲批
起床|起身
起早兒|起五更
起早|起五更
起毛球|紕晒
起淫心|花心
起眼|覺眼
起程|起腳
起訴|檢控
起|起首
起邪念|起痰
起錨|解纜
起鍋兒|起鑊
起雞皮疙瘩|毛管戙
起風|返風
起飛腿|飛踢
趁亂漁利|博亂
趁便|趁手
趁早|趁手
趁火打劫|博亂
趁熱鬧|趁墟
趁著高興|趁高興
超便宜|爛賤
超商|便利店
超支|先使未嚟錢
超級偶像|萬人迷
超級市場|超市
超越到前頭|扒頭
超越|扒頭
超越正常|飛
超車|爬頭
超速駕駛|飛車
超過了時間|過鐘
超過了|過了
超過|過籠
超重|過重
超|長
越來越少|買少見少
越來越有勁|起勢
越區|跨網
越活越年輕|老人成嫩仔
越演越烈|愈吹愈盛
趕上|惡補
趕不及|唔切
趕得及|得切
趕忙|啦啦聲
趕快|快快脆脆
趕着走|趕時間
趕緊|鈴鈴轔轔
趕緊離開|冇鞋挽屐走
趕走|抨
趕路|趕時間
趕進死胡同兒|趕入窮巷
趕集|趁墟
趟|勻
趨向一致|歸一
趨於興旺|發達
趯更|趯路
足不出戶|唔出窟
足夠|夠位
足夠有餘|夠有凸
足|晒
足球巡邊員|邊旗
足球球門|龍門
足癬|香港腳
足足要走|走足
趴下|匐
趴|伏
趴在地上|趴晒地
趴著|仆轉
趿拉|趿
跌一跤|摜一鋪
跌倒|摜親
跌入|䟕入
跌打醫生|跌打師傅
跌跤|打關斗
跌|躂
跌進|跌入
跑不了|唔走得
跑到哪裡去了|趯咗去邊
跑單幫|水客
跑堂|企堂
跑堂兒|企堂
跑外|行街
跑得快|飛風咁快
跑掉|走甩
跑步運動員|跑手
跑氣|漏氣
跑江湖|走埠
跑腿的|散仔
跑腿|走趯
跑|走
跑跑跳跳|扎扎跳
跑跑顛顛|遯遯撲撲
跑車味道|跑味
跑車的特點|跑味
跛子|阿跛
跛行|趷
距離|隔
跟人鬧翻|擘面
跟他|挐佢
跟他說|話畀佢知
跟你|挐你
跟你說|話畀你知
跟別人說|話畀人哋知
跟|同
跟在後面|跟尾
跟在後頭|跟尾
跟女人鬼混|滾
跟屁蟲兒|跟尾狗
跟屁蟲|跟尾狗
跟我|挐我
跟我說|話畀我知
跟手尾|輯手尾
跟手|戾手
跟樣畫葫蘆|照辦煮碗
跟潮流|跟風
跟班|後生
跟著做|照辦煮碗
跟著別人做|睇頭
跟著|跟住
跟蹤|吊尾
跟蹤小組|狗仔隊
跟進跟出|跟出跟入
跟隨|發摟
跟頭|關斗
跨越|檻
跨過|檻過
跪拜時的墊子|跪薦
路不順|撠腳
路人|途人
路口|街口
路子|路數
路攤子|大牌檔
路旁|街邊
路程|水路
路費|水腳
路軌|車軌
路途遙遠|離天九丈遠
路過|留名
跳來跳去|跳跳貢
跳動|趲
跳棋|波子棋
跳槽|過檔
跳皮筋兒|跳橡筋
跳蚤|狗蝨
踉蹌|腳步浮浮
踏實|沉實
踏空|差錯腳
踝子骨|腳眼
踢人|起腳
踢|搓
踢毽子|踢燕
踢球玩|踢波
踢走|踢出局
踢足球的技術|腳法
踢足球|踢波
踢踢踏踏|凌凌林林
踢踢騰騰|凌凌林林
踩到界線上|踩界
踩到界線以外|踩過界
踩水|踩水影
踩空|差錯腳
踩著別人的肩膀|踩住人膊頭
踩西瓜皮|踩蕉皮
踩錯了步子|蹅錯腳
踮起腳尖|躡
踮起腳|扤高腳
蹄兒|腳
蹄子|腳
蹊蹺之事|景轟
蹊蹺的事|景轟
蹊蹺|蹺蹊
蹚|徑
蹦跳|扎扎跳
蹦蹦|卜卜聲
蹦蹦跳|扎扎跳
蹦蹦跳跳|扎扎跳
蹬掉被子|戽被
蹬腿兒了|瓜直
蹬腿兒|雙腳撐直
蹬被子|戽被
蹬被|戽被
蹬|踩
蹲監獄|扽監
蹲|踎
蹺課|走堂
蹺蹺板|搖搖板
躍起|跳
身不由己|洗濕個頭
身價|身家
身兼數職|百足咁多爪
身分|身份
身子動來動去|郁身郁勢
身子搖來搖去|搖身搖勢
身孕|身紀
身形消瘦|落晒形
身故|過身
身旁|側近
身材窈窕|瀟湘
身材苗條|瀟湘
身材高大|牛高馬大
身無分文|拍手冇塵
身邊|側近
身體不好|虛浮
身體底子寒|寒底
身體污垢|老泥
身體潺弱的人|虧柴
身體發熱|身焮
身體虛弱|單薄
身體虛|虛浮
躲債|走債
躲|匿
躲懶|偷雞
躲懶兒|蛇王
躲藏|匿
躲警察|走鬼
躲貓貓|挱盲雞
躲起來|匿埋
躲躲閃閃|閃閃縮縮
躲迷藏|伏匿匿
躲過|走雞
躲開|避
躲雨|避雨
躺在地上折騰|跈地
躺椅|懶佬椅
車仔|手車
車到山前必有路|船到橋頭自然直
車廂|車卡
車後架|後尾架
車照|車牌
車胎放炮|爆呔
車胎|車呔
車輛的登記號碼|車牌
車輪子|車轆
車輪的內帶|車呔
車輪|車轆
車錢|車腳
車隊|車龍
車馬勞頓|舟車勞頓
軌道|車軌
軍號|號筒
軍隊出發|拉差
軟乎乎|軟屄屄
軟和|軟熟
軟弱可欺者|耷頭雞
軟弱無力|冇氣冇力
軟弱|腍
軟椅|梳化椅
軟熟|腍
軟爛|爛
軟爛貌|爛炖炖
軟片|菲林
軟盤|碟
軟綿綿|軟䪏䪏
軟而無韌性|腍
軟而爛|腍啤啤
軟而香甜|腍甜
軟莖|藤
軟蓋|厴
軟飯|爛飯
軟體自由協會|軟體自由協會
軟體|軟件
較少的傷|損
較量|鬥
較高的器物|徛身
較高的沙鍋|徛身煲
載你|車你
輔助警察|輔警
輔助|輔加
輕佻|姣
輕便鐵路|輕鐵
輕傷|皮外傷
輕微的駝背|寒背
輕微駝背|寒背
輕易|閑閑
輕柴油|油渣
輕浮搗蛋的女孩子|笭女
輕浮驕傲|沙塵
輕率|貿貿然
輕而易舉|執豆噉執
輕聲細氣|陰聲細氣
輕聲細語|陰聲細氣
輕視|睇低
輕觸|玷
輕許承諾|下扒輕輕
輕諾|口輕
輕輕|低低地
輕輕去掉|辟
輕輕地|低低地
輕輕搔|惏
輕輕鬆鬆|佗佗佻佻
輛|架
輩分大|長
輩分|輩
輪候的隊伍|人龍
輪子|轆
輪沙蟲|禾蟲
輪流|輪
輪渡|小輪
輪胎破裂|爆呔
輪胎|軚
輪輞|框
輯私|執私
輸了|打輸
輸光|輸晒
輸到家了|輸到貼地
輸得很慘|輸到貼地
輸得清光|洗袋
輸得精光|剝光豬
輸送煤氣的管道|煤氣喉
轆地|轆地沙
轉介|寫紙
轉來轉去|兩頭遯
轉動|擰
轉向相反方向|屈尾十
轉大圈|行大運
轉帳|過水
轉彎|掟彎
轉手|戾手
轉換位置|調轉
轉換|換轉
轉換車道|轉線
轉暖|回南
轉椅|螺旋椅
轉業|轉行
轉眼|眨下眼
轉筆刀|筆刨
轉義為看不起他|當佢冇嚟
轉葉式送風電扇|鴻運扇
轉葉電扇|鴻運扇
轉託|搭上搭
轉變|轉
轉賬|過數
轉身|調轉頭
轉速快|衡
轉過來|調轉
轉過相反的方向|掉轉頭
轉過臉去|戾乜面
轉開|擰開
轎夫|轎佬
轎子|轎
轟轟|耾耾
辛勞的開創者|開荒牛
辛勤|勤力
辛巴威|津巴布韋
辛苦|嗍氣
辛苦撫養|挨
辛苦的命|馬命
辛辛苦苦掙錢|辛苦搵嚟自在食
辜負|負
辟邪|治邪
辦事不踏實|水汪
辦事丟三拉四的人|失魂魚
辦事無條理|失魂
辦事爽快|爽手
辦伙食|煮食
辦公室|寫字樓
辦喜事|拉埋天窗
辦妥|攪掂
辦|搞
辦法|計
辦理|辦
辨事無章程|冇搭颯
辨別|識辨
辨法|計仔
辨認|記認
辭工不幹|炒老板魷魚
辭工作|捲鋪蓋
辭工|執包袱
辭演|劈炮唔撈
辭職|唔撈
辭退|起轎
辮子|孖辮
辯論到曲直分明|詏到掂
辯論|鬥駁
農曆十二月十六|尾禡
農曆年初|請春茗
農曆年底|年晚
農曆正用初二|頭禡
農民曆|通勝
農民|耕田佬
迂腐|迂滯
迅疾|零零林林
迅速|快脆
近乎兒|埋
近來|呢牌
近情合理|就話
近旁|側跟
近期|近牌
近身妹|裙腳妹
返回|返去
返老還童|老人成嫩仔
迦納|加納
迫不及待|急不及待
迫使|逼使
迫在眉睫|火燒眼眉
迴紋針|萬字夾
迴避|大耍太極
迷人|惹火
迷住了|迷死
迷信品|紙紮
迷信舉動|請仙
迷信說法|童子口
迷|冧
迷失方向|唔知定
迷失|盪失
迷糊|懵
迷路|蕩失路
迷迷糊糊|昏昏沌沌
追問不放|鞫
追收欠債的人|收數佬
追求者|觀音兵
追著|追實
追討欠款|追數
退休|收山
退回|畀返
退後|褪
退款|回水
退潮|水落
退熱|消熱
退瓶子|回樽
退票|回水
退縮|褪舦
退訂|㒓訂
退還|畀返
退錢|回水
送信|派信
送報生|報紙佬
送有關部門檢查|送檢
送東西|送乜送物
送禮|做人情
送行|送車
送賀禮|做人情
送飯用的提盒|飯格
逃不出我手心|飛唔過我手指罅
逃命|散水
逃學|走堂
逃脫|走雞
逃|走
逃走|走路
逃跑|走路
逃避追捕|走鬼
逆反|反
逆耳|哽耳
透不過氣|唞唔到氣
透了|晒
透徹|通透
透支|碌爆
透明瓦|光瓦
逐漸減少|買少見少
途中|半途中
逗人喜歡|趣致
逗哏|搞笑
逗弄|攎
逗|撩
逗樂兒|惹笑
逗樂|搞笑
逗笑|攪笑
逗趣兒|攪笑
逗趣|攪笑
這一|
這一刻|這刻
這一回|呢勻
這一次|今次
這一段|呢一輪
這一生|呢世人
這一種|呢樣
這一輩子|呢世人
這一陣|呢排
這一陣子|呢排
這一面|呢便
這些|啲
這些天|呢排
這些日子|呢一牌
這份|份
這個|個
這個地方|呢度
這個月|今個月
這個混蛋|條躝癱
這個那個|乜乜物物
這兒|呢度
這又是|咁又係
這口氣兒不順|條氣唔順
這|呢
這回|呢勻
這堵牆|幅牆
這塊|呢笪
這塊土地|這幅地
這塊地|這幅地
這夥人|班人
這幫壞蛋|班躝癱
這張|張
這時候|這刻
這時|這刻
這會兒|而家
這本|本
這條|條
這棵|樖
這樣一來|就係噉
這樣做|咁搞法
這樣|噉
這樣子|咁
這樣就|咁就
這樣的|噉樣嘅
這樣的話|噉樣
這樣看來|照咁睇
這樣說|咁講
這樣那樣|乜乜物物
這次|今次
這片土地|這幅地
這種|呢款
這種醬那種醬|乜醬物醬
這節課|今堂
這群人|班人
這裏|呢處
這道數學題目|條數
這道菜|呢味餸
這邊兒|呢便
這邊|呢度
這部電影|套電影
這部電腦|部電腦
這門生意|呢盤生意
這陣子|呢排
這隻|只
這面|呢便
這頂帽子|頂帽
這麼多|咁多
這麼|恁
這麼着|噉樣
這麼誇張|咁誇
這麼零碎|雞碎咁多
通力合作|拍硬檔
通同一氣|打同通
通報|投訴
通心麵|通粉
通情達理|熟性
通書|通勝
通殺|冚家剷
通紅|紅噹噹
通菜|通心菜
通融|搭路
通貨膨脹的百分比率|通脹率
通貨膨脹的簡稱|通脹
通通給|畀晒
通過|透過
通電話|傾電話
通風報信|通水
通風|扯風
逛大街|行街
逛年宵市場|行花市
逛百貨公司|行公司
逛花市|行花市
逛街|行街
逝世|過身
逞能|讕㔹
速度大|衡
速查表|貓紙
速食麵|公仔麪
造作|作狀
造反|作反
造孽|折墮
造成|做成
造|整
造訪|到訪
造謠|亂作
造輿論|放聲氣
逢人問路|口在路邊
連不上|上唔到
連同|夾埋
連在一起|掕埋一堆
連帶|帶挈
連得上|上到
連接|接通
連環圖|公仔書
連環畫|公仔書
連發的槍|快掣
連累人倒運|佗衰
連累人倒霉|佗衰
連累別人倒霉|佗衰
連累別人|害人害物
連累到|累着
連累|馱累
連繫|聯繫
連續不斷|枕住
連續劇|劇集
連續|直落
連衣裙|衫裙
連襟兒|老襟
連襟|襟兄弟
連身泳衣|一件頭
連連說不|耍手擰頭
連陰天|長命雨
連雨天|長命雨
逮捕|拉
週|周
進了|入到
進了腰包|落袋
進來|入嚟
進|入住
進入|入嚟
進入高潮|入肉
進到|入到
進去|入去
進口貨|來路貨
進場|入場
進帳|落袋
進球|入樽
進監獄|食皇家飯
進行|去
進行犯罪活動|做世界
進貨|入貨
進退兩難|兩頭唔到岸
進退維谷|半天吊
進進出出|出出入入
逼供|迫供
逼到墻角|趕入窮巷
逼狗跳牆|趕入窮巷
逼狹|逼窄
逼|監
逼虎跳牆|趕入窮巷
逼責|質
逼迫|逼
遁走|較飛
遇到困難|唔掂
遇|碰
遊戲室|打機室
遊戲機室|打機室
遊戲機店|機鋪
遊歷|遊埠
遊玩|玩
遊盪|躝街
遊蕩|迆
遊覽|玩
遊逛|行逛
遊遍|去盡
運動服裝|體育衫
運動衣|波衫
運動褲|波褲
運動鞋|波鞋
運|喐
運氣不好|欠運
運氣|命水
運氣壞|運滯
運氣好|好彩數
運氣真好|真係好彩
運泥車|泥頭車
運行|行
運貨小板車|豬籠車
運貨的費用|水腳
運貨費用|貨腳
運費|水腳
運輸|車
運送|車
遍尋不獲|打鑼都搵唔到
過一會兒|等陣
過世|過身
過了一會兒|隔了不久
過了暑假|抖完暑
過了|過埋
過了頭|過龍
過份善良|腍
過份老成的孩子|老人精
過份|過態
過來|過嚟
過冬節|過冬
過冬至節|做冬
過分|離譜
過去的|舊
過去|舊時
過問|理
過堂費|堂費
過完|過埋
過家家兒|玩煮飯飯
過寬|闊朗淌
過年|出年
過幾天|遲幾日
過得去|麻麻地
過得硬|過骨
過得舒服|封相
過意不去|唔好意思
過敏|敏感
過於肥大|闊朗淌
過時|過氣
過時間|過鐘
過河拆橋|過橋抽板
過油|走油
過港|過海
過濾|淠
過火|過了火位
過癮|抵死
過禮的俗稱|擔茶
過站而不停|飛站
過節日|過節
過街樓|騎樓
過較寬的河流|過海
過道|冷巷
過長了|長拉拉
過長|長䧒䧒
過關|過骨
過頭|過籠
過高估計|看高
道具|架撐
道地|地道
道士|南無佬
道教徒|道士
道理|解究
道菜|味
道觀|齋堂
道路淹水|水浸街
達不到|唔得
達到|到
達到目的|得食
達到頂點|頂籠
達官|大粒
違建|僭建
違章建築|僭建物
遙遙領先|遙遙領前
遙遠|冇雷公咁遠
遛大街|逛街
遜色|輸蝕
遜|頹
遠房親戚|疏堂老表
遠足|行山
適口|敹口
適合|啱
適應|服
遭不幸|折墮
遭刁難|識貌麵
遭受兩面打擊|挨夾棍
遭受|受
遭殃|當災
遭水災|水浸
遭雷劈|着雷劈
遮斷|隔
遮眼|揞眼
遮雨篷|檐篷
遲了許多|遲大到
遲了點|晏咗
遲到很長時間|遲大到
遲到|過鐘
遲|摩
遲收|晚
遲鈍|木獨
遵照群眾的要求|徇眾要求
遷就|就住
遷居|搬屋
遷移到|搬去
選取|喺度揀
選單|菜牌
選定群鬥的場所|擺場
選房子|揀樓
選|揀
選擇好|擇
選擇|揀
選購衣物|睇衫
選項|隨寫
遺下|攋低
遺像|真
遺尿的孩子|賴尿蝦
遺|拉
遺棄|飛起
遺漏|漏
遺留下來的麻煩事|手尾
遺留下的麻煩事|蘇州屎
遺留|落低
避債|走債
避孕套|安全套
避小害而失大利|斬腳趾避沙蟲
避暑|唞暑
避諱|避忌
避開|避
邀約|嘍
邁|揇
還不|仲唔
還不行|未得自
還不錯|幾好吃
還以為|仲估
還剩|爭
還加上|仲兼
還原|恢復
還可以|幾好
還好"|一般勁
還好|好在
還早著呢|未有耐
還是|都係
還會|尚識
還有好長時間才|未有耐
還有|尚有
還有很長時間|有排
還未|尚未
還比較好|仲好
還沒|尚未
還沒有|尚未
還沒空|未得閒
還湊合|麻麻哋
還用得著說嗎|使乜講
還能用|仲使得
還能|都好
還行|過得去
還要|尚要
還要過很久|有牌
還說|仲話
還錢|找數
還願|酬神
邊上|邊邊
邊境|邊
邊很淺|淺身
邊沿高|高身
邊界|界
邊綫球|界外球
邊緣不平整|狗牙
邊緣|舋尾
邋遢|藞苴
邋邋遢|乞兒相
邏輯性不強|冇紋路
邏輯性強|有紋路
邑部|斧頭邊
那一|
那一刻|嗰刻
那些年|當年
那個|嗰個
那倒未必|噉又唔一定
那|咁
那大數量|大拿拿
那天|嗰日
那就|噉就
那就這樣|係噉先喇
那時候|個陣
那時|嗰陣
那本|本
那棵|樖
那樣|噉
那樣的|噉樣嘅
那班|一班
那裏|度
那裡|嗰度
那還用說|使乜講
那邊|嗰度
那頂帽子|頂帽
那麼巧|恁啱
那麼|恁
那麼近|咁舋
那麼長|流流長
郎貓|貓公
部位|面
部分|部份
部|架
都不行|都幾難
都去|去晒
都可以|是但
都是因為|皆因
都用|用晒
都羨慕|都恨
鄉下|鄉下
鄉巴佬|鄉下佬
鄉親|老鄉
鄉間有威望的人|紳衿父老
鄉間|鄉下
鄉音|音底
鄭重叮嚀|千祈
鄰居|街坊
鄰近|隔籬鄰舍
鄰里老太婆|隔籬二叔婆
鄰|隔離
配上|襯
配合|襯埋
配合默契|咬弦
配得上|合襯
配得起|登對
配料|料
配有菜肴的份飯|碗頭飯
配種|打種
配色|兼色
配菜|配料
配|襯
配襯|合襯
配襯甚麼也可以|百搭
酒席|擺酒
酒底子|酒垽
酒樓|茶居
酒渦|酒凹
酒窩|酒凹
酒精|火酒
酒糟鼻子|皻鼻
酒肉之交|靠飲靠食
酒足飯飽|飲飽食醉
酒醉飯飽|飲飽食醉
酒量大|好飲得
酒鬼|醉貓
酗酒|爛飲
酥脆|鬆化
酥軟|腍
酥|鬆化
酪梨|牛油果
酬神|還神
酬謝贈錢|利市
酵母|酒餅
酷愛讀書的人|書蟲
酸味調味品之一|醋
酸溜溜|酸微微
酸痛|㾓痛
酸癢的感覺|肉酸
酸菜|鹹酸菜
酸酸的味道|酸味味
酸麻|㾓痛痹痹
醃酸黃瓜|黃瓜酸
醉漢|醉貓
醉鬼|醉酒佬
醋勁兒|醋味
醋溜魚|五柳魚
醋缸子|醋埕
醋罈子|醋埕
醋腌瓜菜|咸酸
醒悟|醒覺
醒目|搶眼
醜|肉酸
醜話說在前頭|大吉利時講句
醜陋|猾突
醫生處方|醫生紙
醫療費用|湯藥費
醫葯費|湯葯費
醫術高明|明功
醫道好|明功
醬油|豉油
醬瓜|茶瓜
醬豆腐|南乳
醮火|灒
釀製醋用的引子|醋種
釀酒|浸酒
釋出|推出
釋放出獄|出冊
釋放|放
釋迦|番荔枝
里肌肉|脢肉
里肌|脢頭
里脊肉|脢肉
重來|翻生
重信用|講口齒
重刷|刷新
重徒孫|徒塞
重感冒|大傷風
重擊聲|乓乓聲
重新下載|取得返
重新命名|名返
重新啟動|開返
重新執行|行返
重新安排或商量|走趲
重新安裝|裝返
重新思考|諗翻轉頭
重新打造|造返
重新打鼓另開張|拆棚做過
重新整理|整返
重新|翻手
重新載入|載返
重新進入|入返
重新開始|拆棚做過
重添脂粉|補粉
重看|睇返
重複人家的話|執人口水溦
重要的日子|大日子
重要|緊要
重視|重
重質不重量|貴精不貴多
重量單位|釐
重量大|重
重量|重
野人|生番
野心大|勢凶夾狼
野生的貓|野貓
野男人|老襟
野菜|油麥菜
野蠻人|生番
野蠻|番蠻
野豬|山豬
野雞|山雞
野雞翎|雉雞尾
野鴨子|野水鴨
野鴨|野水鴨
量地方|度位
量尺寸|度身
量尺|間尺
量|度
量詞|劑
量身定做衣服|度身做衫
量身打造|度身打造
量身訂做|度身打造
量體溫|探熱
金信用卡|金咭
金勞力士腕錶|金撈
金器店|金鋪
金子|金
金屬閘門|捲閘
金槍魚|吞拿魚
金毛狗|黃狗毛
金氏世界紀錄|健力士世界紀錄
金環蛇|金腳帶
金綫魚|紅三
金色|金
金質|金
金錢|錢銀
金鑰|密碼匙
金鑲玉竹|金竹
金魚眼|凸眼
金龜|草龜
釘子|釘
釘緊|碼
釘釘子|搨釘
針對|啄
針眼|眼挑針
針管兒|針筒
針腳|線步
針鼻兒|針眼
針鼻|針眼
鈍|屈
鈍拙|蠢鈍
鈔票|銀紙
鈕扣|衫鈕
鈴兒花|吊鐘
鈴鐺|鋃鋃
鈴響|響緊
鈴鼓|噹噹
鈽|鈈
鉆研|刨
鉗子|鉗
鉚釘|窩釘
鉛字|字粒
鉛筆刀|筆刨
鉛筆盒|筆袋
鉲|鐦
鉳|錇
銀灰色|鼠灰
銀環蛇|銀腳帶
銀耳|雪耳
銀行存摺|紅簿仔
銀行支票|本票
銀鋪|錢莊
銀魚|白飯魚
銅仙|仙
銅子兒|仙屎
銅筋鐵骨|銅皮鐵骨
銳|鋭
銷不了贓|唔落膈
銷毀|毀
銻鍋|銻煲
鋁合金|飛機銻
鋁的俗稱|銻
鋁製的鍋|銻煲
鋁質炒菜鍋|鋁鑊
鋁|銻
鋁錠|鋁磚
鋁鍋|銻煲
鋂|鎇
鋅|星鐵
鋒利|利
鋪子的門面|鋪面
鋪子|鋪頭
鋪床|行床
鋪蓋|被鋪
鋪設|鋪
鋪路修橋|修橋整路
鋪開|鋪
鋸|刉
鋸子|鋸
鋸末|木糠
鋸齒狀|狗牙
鋸齒|鋸牙
鋼印|凹凸印
鋼瓶裝液化石油氣|邊爐氣
鋼筆|水筆
鋼筋森林|石屎森林
鋼筋|鋼骨
鋼精鍋|銻煲
鋼絲|威也
鋼軌|車軌
錄供|落口供
錄像機|攝錄機
錄取供詞|落口供
錄取|取錄
錄口供|落口供
錄音|錄歌
錐子|錐仔
錐栗|錐仔
錘子|錘
錙銖必較|知微
錢不夠花|唔夠銀
錢包|銀包
錢很多的人|水喉
錢會的參加者|會仔
錢款付受|磅水
錢毛了|折水
錢的問題|錢銀問題
錢箱|錢罌
錢財|水頭
錢鈔|水頭
錯不了了|冇死咯
錯失良機|走寶
錯就錯在|弊就弊在
錯怪|怪錯
錯放|放錯
錯斷病情|斷錯症
錯漏|甩漏
錯用情|表錯情
錯誤地|錯誤噉
錯誤|謬俚
錯車|避車
錯過了好處|走寶
錯過了|送車尾
錯過|放過
錯過機會|失拖
錶內的發條|錶鏈
錶瓤兒|錶肉
錶瓤|錶肉
錶盤|錶面
錶芯|錶肉
錶蒙子|錶蓋
錼|鎿
鍅|鈁
鍋垢|鑊黸
鍋巴|飯焦
鍋底灰|鑊撈
鍋灰|鑊撈
鍋碗瓢盆|砂煲罌罉
鍋蓋|飯蓋
鍋貼兒|煎餃
鍋鏟兒|鑊鏟
鍋鏟|鑊鏟
鍋|鑊
鍍鋅鐵皮|星鐵
鎖上|錔埋度
鎖了|鎖住
鎖匙鏈|鎖匙扣
鎖物用的鏈子|鎖鏈
鎖眼兒|鎖匙窿
鎖紐扣眼兒|鎖紐門
鎖著|鎖住
鎖起來|鎖住
鎖邊兒|鈒骨
鎖邊|鈒骨
鎝|鍀
鎦|鑥
鎬頭|十字鋤
鎮定|定當
鎮定自若|定過抬油
鎮流器|火牛
鎮靜|定
鏈子|鏈
鏈|捵
鏈結|連結
鏈魚|扁魚
鏟子|鑊鏟
鏟|杵
鏡子|鏡
鏡框|鏡架
鐘|時辰鐘
鐘錶的發條|鏈
鐘錶|鐘
鐘頭|點鐘
鐘點兒女工|鐘點女傭
鐘點|鐘數
鐮刀|禾鐮
鐵做的小炮仗|炮仔
鐵價不二|一口價
鐵公雞|鐵沙梨
鐵制撬杠|鐵筆
鐵合頁|骹
鐵撬杠|鐵筆
鐵枝兒|鐵枝
鐵柵欄|鐵閘
鐵柵欄門|鐵閘
鐵柵門|鐵閘
鐵條|鐵枝
鐵棍|鐵通
鐵欄杆|鐵馬
鐵水管|水喉鐵
鐵管兒|水喉鐵
鐵絲|鐵線
鐵罐|嘜
鐵路|車路
鐵軌|路軌
鐵道|車路
鐵鍬|鐵鏟
鑀|鎄
鑄模|倒模
鑰匙圈|匙扣
鑰匙孔|鎖匙竉
鑰匙環|鎖匙扣
鑰匙|鎖匙
鑲嵌|嵌
鑲邊|綑邊
鑷子|夾鉗
鑽書|刨
鑽書本|刨書
鑽法律的空子|走法律罅
鑽法律空子|鑽法律罅
鑽空子|博亂
鑽|錑
鑽鼻|攻鼻
鑿子吃木頭|斧頭打鑿鑿打木
長不大|大唔透
長了呱嘰|長拉拉
長假期|大假
長出腱子肉|起腱
長壽的人|壽星公
長大了|大個仔
長大|大個
長女|大女
長子|頭長仔
長度|長
長得喜相|歡容
長得醜|深睛凸額
長得醜陋的人|豬頭
長得難看|醜樣
長成|生埋
長把梨|雪梨
長方臉形|國字口面
長時間地煮|煲
長時間|好耐
長時間閑談|煲粥
長期不斷|枕住
長期倒霉|累世
長期經常|枕長
長期顧客|熟客仔
長杉木材|杉
長板凳|橋凳
長條板凳|條凳
長椅|杠床
長毛狗|鬆毛狗
長眼睛|帶眼
長着大鬍子的人|鬍鬚公
長短腿|長短腳
長竹竿|竹篙
長篇大論|一疋布咁長
長肉|生肉
長胖|生肉
長葉萵苣|油麥菜
長著絡鬍的人|鬍鬚佬
長處|長
長蟲|生蟲
長袖套頭衫|過頭笠
長袖運動服|波恤
長豇豆|白豆
長這麼大|咁大個仔
長針眼|生眼挑針
長|長流流
長長|長拉拉
長駐|長踞
長高|䅺高
長麻子的人|豆皮
長齙牙|哨牙
門可羅雀|曬蓆
門坎兒|門槧
門庭若市|旺市
門廳|大堂
門插關兒|門戌
門檻兒|門檻
門檻|門槧
門派的掌舵人|掌門人
門牙向前突出|齙牙
門神貼錯了|貼錯門神
門窗的插銷|戌
門紐|門髻
門縫兒|門罅
門縫|門罅
門診|街症
門路|窿罅
門鈴|門鐘
門隙|門罅
閂|戌
閃亮|閃靚
閃爍其詞|支離
閃|蹔
閃閃發亮|閃閃令
閃開|借
閃電|天霎
閃電講|短講
閉上眼睛|眯埋眼
閉口|埋口
閉嘴|收聲
閉眼|瞌眼
開價|叫價
開刀|割
開到|駛到
開口就罵人|臭口爛舌
開口棗|笑口棗
開口笑|笑口棗
開口閉口|開口埋口
開口|開聲
開司米|茄士咩
開啟|開
開場鑼鼓|頭鑼
開夜車|捱更抵夜
開始動身|起腳
開始拍攝|埋位
開始播音工作|開咪
開始營業|開檔
開始的數天|頭幾日
開始行動|起錨
開始|起首
開始"|開頭
開小差|偷雞
開市|開鋪
開店營業|開檔
開張|開檔
開心地笑的人|笑口棗
開戰|開片
開打|開片
開拓|拓展
開拓者|開荒牛
開支|使費
開新燈|開燈
開業|開張
開機器的工人|機器佬
開水|滾水
開火|開爐
開燈|着燈
開玩笑|講笑
開綻|哆
開胃|醒胃
開船|揸船
開襠褲|開𧟘褲
開設|辦
開誠佈公|開心見誠
開誠相見|開心見誠
開車兜風|遊車河
開車|揸車
開進|駛入
開銷|使費
開門營業|開鋪
開門|開舖
開關不夠用|唔夠掣用
開關|掣
開闢為商埠|開埠
開頭|起首
開飛機|揸飛機
開飯|開餐
閑不住|冇時閑
閑坐無事|冇細藝
閑聊|打牙骹
閑話|閑偈
閑談|傾蓋
閒聊|傾閒蓋
閒逛|逛街
間架|間隔
間條|間行
間隔著|梅花間竹
間隔開|兼開
間隔|隔
間雜排列|梅花間竹
間雜|褦
閘|掣
閘門|閘
閣樓|閣仔
閨女|後生女
閱讀資料|睇料
閱|閲
閹|剦
閹割了的公牛|牛牯
閹雞|鏾雞
閻王賬|貴利
闊佬|猛人
闊少爺|阿瓜
闊氣|闊佬
闊綽|闊佬
闌尾|橫丫腸
闖大禍|大單
闖江湖|撈世界
闖禍|撞板
關上門|閂到門
關不上門|閂唔到門
關你屁事|關人鬼事
關係到|關乎
關係很親密|糖黐豆
關係|拏掕
關係曖昧|唔湯唔水
關係近|親
關卡|卡口
關口|關
關帝廳|關帝廟
關店門|閂鋪
關張|執笠
關心|著緊
關我何事|關人乜事
關押|圂
關掉引擎|熄匙
關掉|整熄
關於|有關
關機|熄機
關注|着意
關涉|關
關照|帶挈
關燈|熄燈
關禁閉|圂
關節脫臼|甩骹
關起來|圂
關連|挐掕
關鍵|骨
關門兒|閂鋪
關|閂
關閉|閂埋
關閉電腦|熄機
阜部|斧頭邊
防曬油|太陽油
防洪堤|基圍
防潮堤|基圍
防火塑料|防火膠
防火巷|冷巷
防火逃生|走火
防疫注射證明|打針紙
防範|垂
阻截|閂死
阻擋|阻住
阻斷|杯葛
阻止|打躓
阻礙|阻滯
阻隔|隔
阿諛奉承|擦鞋
阿諛|戴高帽
阿飛|飛仔
陀螺|定螺
附加|佮埋
附帶|帶挈
附近|左近
陌生人|生部人
陌生|生暴
降伏|收伏
降火飲料|涼茶
降級|降班
降職|炖冬菇
降落|着陸
限制|制
限制用水|制水
限制用電|制電
限定時間完成|限時限刻
限定載客人數|限載人數
限隨和|好相與
陡坡|長命斜
陡|笡
陣兒|輪
陣勢|陣仗
陣子|輪
陣容|卡士
陣容強大|大卡士
陣|朕
陣雨|過雲雨
除下|脫
除去|剷走
除夕夜家人團聚|團年
除夕|年晚
除掉|除拆
陪伴|傍
陪同|湊
陪嫁|妝嫁
陪小孩睡覺|暗
陪床|陪住
陪房|陪嫁妹
陪著人家談情說愛|剝花生
陰冷陰冷|陰陰凍
陰囊|脧袋
陰天|天陰
陰暗|翳
陰涼兒|遮陰
陰溝|暗渠
陰莖|鳩
陰陽怪氣|鬼聲鬼氣
陰陽生|喃嘸佬
陰險狡猾|蛇頭鼠眼
陰險|陰溼
陳年舊事|前塵往事
陳舊的事物|陳皮咁舊
陳舊|陳皮
陶器店|缸瓦舖
陶醉極了|冧晒
陷入|凹
陷入困境|阿哩吉諦
陷害別人|推人落井
陷害我|𧥺我
陷害|靠害
陷阱|中招
陸陸續續|陸續有嚟
陽光很充足強烈|曬
陽光|日頭
陽具|不文物
陽台下面|騎樓底
陽台|天棚
陽春麵|淨麵
陽曆新年|新曆年
陽臺|騎樓
隆隆|靇靇
隊列操練|步操
隊|排
隊末|龍尾
隔一陣子|耐唔耐
隔三差五|耐唔中
隔些時|耐唔中
隔壁兒|隔籬
隔壁|隔籬
隔壁飯香|本地薑唔辣
隔夜|過夜
隔絕|斷
隔開|屏開
隔閡|隔膜
障礙|隔膜
隨他去|由得佢
隨便一個人|阿豬阿狗
隨便他吧|由得佢喇
隨便他|由得佢
隨便|是但
隨便許諾|下巴輕輕
隨便說話|下巴輕輕
隨便講|隨口噏
隨口說着玩|貪口爽
隨和|好好人
隨大流|睇頭
隨後|跟手
隨意拿取|任拿
隨意|捩手
隨手|捩手
隨時|分分鐘
隨時隨地|隨時隨地
隨機應變|執生
隨犬溜兒|跟大隊
隨著|跟住
隨身碟|記憶棒
隨身追訪|貼身追訪
隨附|跟機
隨隨便便|求祈
隱形者|攝青鬼
隱形|隱身
隱瞞|遮瞞
隱私|私隱
隱藏|匿埋
隱藏實力|雪藏
隱語|背語
隱隱作痛|𣤩𣤩痛
雄性豬|豬公
雄貓|貓公
雄雞的冠子|雞冠
雄魚的精液|魚獲
雅致|清景
雅觀|養眼
集中注意力|打醒精神
集合|齊集
集裝箱|貨櫃
集鎮|鎮頭
雕刻用的刀|鏨刀
雕刻|雕
雖然|冇疑
雙下巴|雙胎下爬
雙人床|大床
雙人旁|雙企人
雙倍地增加|耷保
雙倍|打孖
雙層床|轆架床
雙幅|雙封
雙手|對手
雙排扣|雙襟
雙排紐扣|雙襟
雙方一起|兩家
雙方各有一份|兩份
雙方都推搪|拉鋸
雙棒兒|孖女
雙生兒|孖女
雙生|孖仔
雙眼|對眼
雙立人兒|雙徛人
雙胞出生|孖生
雙胞胎兄弟|孖仔
雙胞胎姊妹|孖女
雙胞胎|孖仔
雙腿發軟|發軟蹄
雙腿顫抖|腳震震
雙辮|孖辮
雛鴿|乳鴿
雜七雜八|立雜
雜亂|拉雜
雜八湊兒|雜巴冷
雜嘴子|口痕
雜役|雜差
雜拌兒|雜崩冷
雜活|下欄
雜牌兒|雜嘜
雜物店|辦館
雜碎|雜
雜種|打亂種
雜腳|雜
雜貨店|士多店
雜貨舖兒|士多店
雜貨鋪兒|士多
雜項費用|除拆
雞內臟的總稱|雞雜
雞卵|雞蛋
雞吃食時咳嗽|雞哽頸
雞嘴鋤|鶴嘴鋤
雞塊|雞球
雞子兒|雞春
雞屎果|番石榴
雞朴|雞殼
雞毛撢子|雞毛掃
雞毛蒜皮的小事|少少事
雞毛蒜皮|脂麻綠豆
雞爪子|鳳爪
雞犬不寧|雞毛鴨血
雞的胃|雞腎
雞的腦袋|雞頭
雞的腸子|雞腸
雞皮疙瘩|雞皮
雞籠|雞罩
雞翅膀|雞翼
雞翅|雞翼
雞肉包|雞包
雞肫|雞腎
雞胇|雞子
雞胗|雞腎
雞腰|雞子
雞腳|鳳爪
雞腿|雞髀
雞蛋卷|蛋筒
雞蛋的舊稱|雞春
雞蛋盞|蛋撻
雞蛋糕|雞蛋仔
雞蛋糖水|蛋茶
雞蛋羹|水蛋
雞雜|雞扶翅
雞雞|且且
雞零狗碎|雞碎咁多
離世|過身
離了婚|失婚
離了本|出位
離去|出走
離合器|極力子
離婚|拆檔
離家遠行|出門
離得稍遠的地方|開便
離得遠|離天隔丈遠
離異|掟煲
離線|唔喺網上
離邊沿近|抆
離開座位|出位
離開本地|出埠
離開|行開
難下嚥|惡骾
難以下咽|難骾
難以了解清楚|唔清唔楚
難以忍受|難抵
難以忍耐|難頂
難以捉摸|神神化化
難以收拾|爛
難以決斷|心大心細
難以理解|難明
難以看好|凍過水
難以計算|禁計
難以預料|話唔埋
難侍候|囉嗦
難倒|考起
難兄難弟|砂煲兄弟
難免|少不免
難受|辛苦
難吃|惡骾
難堪|狼狂
難對付|利害
難得|冇幾何
難怪|唔怪得
難收的賬|爛賬
難於|惡意
難為情|醜死怪
難為|虧
難熬|難頂
難相處|澀滯
難看的樣子|貓樣
難看|肉酸
難聞的酸臭味|酸宿爛臭
難聽|肉酸
難聽點說句|大吉利時講句
難調教|牛精
難辦|撠手
難辨|擇使
難過|唔開心
難道不是嗎|咪係
難道|唔通
難題|死綟
雨衣|雨褸
雨靴|水鞋
雨鞋|水鞋
雪利酒|些厘酒
雪梨|悉尼
雪白|白雪雪
雪白雪白|白蒙蒙
雪茄煙|呂宋煙
雲霄飛車|過山車
零亂不堪|七零八落
零亂|淋淋瀋瀋
零售|散賣
零嘴|口立濕
零敲碎打|濕
零用錢|散使
零|碎
零碎數|零丁
零碎|𦠿碎
零票兒|散紙
零票子|散紙
零票|散紙
零花兒|散使
零賣|散賣
零鈔|碎紙
零錢|散銀
零零散散|散收收
零零碎碎|頭頭尾尾
零零落落|零星落索
零食|閒口
雷射|鐳射
雷打|畀雷劈
雷神|雷公
雷|雷公
雹子|雪珠
雹|雪珠
電冰箱|雪櫃
電動機|摩打
電吹風|風筒
電單車|綿羊
電器店|電器舖
電子辭典機|辭典機
電度表|電表
電影情節|戲橋
電影|戲
電影錄像磁帶|影帶
電扇|風扇
電扶梯|手扶電梯
電時鐘|電鐘
電梯|升降機
電池|電芯
電泡|電燈膽
電源供應器|火牛
電源插座|插蘇
電源插頭|插蘇
電源正極綫|火綫
電源負極綫|水綫
電漿|等離子
電熱吹風器|風筒
電燈泡|燈膽
電燈膽|燈膽
電線杆|電燈杉
電線桿|電燈杉
電視劇|劇
電話接線生|接線生
電鈴|電鐘
電鋃鐘|電鐘
電鍋|電飯煲
電門鈴|門鐘
電閘|鮑魚掣
電|電芯
電風扇|風扇
電飯鍋|電飯煲
霄壤之別|爭天共地
震動|震
霉到極|衰到貼地
霉味|蔫臭
霉爛|霉
霎時間|霎時
霧氣|霞氣
霧|霞霧
霰彈獵槍|砂槍
霰|魚眼雪
露兇光|𧢝𧢝
露出來|打
露出|凸
露出牙齒|𡄵起棚牙
露水夫妻|霧水夫妻
露水|霧水
露肩女裝|卸肩裝
露臉|得色
露面|浮頭
露面的多少|曝光率
露餡餅|撻
霸佔前面位子|搶頭位
霸道之極|大晒
霸道|惡爺
靈機一動|靈機一觸
靈活|醒水
靈牌|神主牌
靈驗|靈
青一塊紫一塊|瘀
青不嘰|青啤啤
青光眼|發青光
青年女子|後生女
青年男女|後生仔女
青年男子|後生仔
青春疙瘩|青春豆
青春痘|痘痘
青春豆|酒米
青果|白欖
青椒|燈籠椒
青皮蔗|白蔗
青花菜|西蘭花
青草|青
青蛙|田雞
青衣轎的布簾|轎衣
青豆角|青豆
青青|青啤啤
青顏色|青
青魚|黑鯇
靜俏俏|靜英英
靜悄悄|靜英英
靜捎捎|靜鷹鷹
靜靜|靜雞雞
非全時間修讀|兼讀
非常亂|七國咁亂
非常便宜|平到笑
非常便宜的價格|極低價
非常倒楣|好唔好彩
非常倒運|黑過墨斗
非常冷清|鬼影都冇隻
非常凌亂|七國咁亂
非常嘈雜|鬼殺咁嘈
非常壞|衰到極
非常多|多到死
非常好|好到極
非常害怕|慌死
非常容易做|當食生菜
非常容易|話咁易
非常差|極其之差
非常快活|不知幾爽
非常急迫|火燒眼眉
非常想|好欿
非常懂得|好識
非常懶惰|蛇王
非常時髦|型到痹
非常|極
非常混亂|七國咁亂
非常清醒|鬼打咁醒
非常渴|喉乾頸涸
非常漂亮|鬼火咁靚
非常潔白|白雪雪
非常濃|杰撻撻
非常煩|煩到死
非常甜美|甜到漏
非常疏|疏寥寥
非常瘋狂|癲到冇倫
非常瘦|面冇四兩肉
非常相似|餅印
非常相配|襯到絕
非常看不起|睇衰
非常矮|矮凸凸
非常破爛|融融爛爛
非常稠|杰撻撻
非常穩定|打風打唔甩
非常笨|蠢到極
非常糊塗|大懵
非常糊塗的人|烏龍王
非常肯定|的而且確
非常舊|古老十八代
非常調皮的小孩|星君仔
非常走運|行運行到腳趾公
非常辛苦|苦過弟弟
非常零碎|碎濕濕
非常非常|極
非常順利|順風順水
非常頑皮|曳到死
非常齊平|齊葺葺
非整數|零丁
非正當行業|偏門
非法入境的匪徒|蛇匪
非法入境者|人蛇
非法娼賭場所|架步
非法的行當|偏門
靠上去|埋去
靠不住|冇腰骨
靠不住的東西|三腳凳
靠估計|斷估
靠在|凭喺
靠外側|開邊
靠外邊的位置|開便
靠外邊|開便
靠外面|開便
靠天吃飯|望天打卦
靠山|威勢
靠岸|埋頭
靠左邊走|左行
靠後|舋尾
靠|憑
靠碼頭|埋頭
靠站|埋站
靠背|挨屏
靠著|靠住
靠蠻勁|靠鋪牛力
靠裏頭|埋便
靠裡邊|埋便
靠辦善堂發財者|善棍
靠近物體的地方|邊
靠近船頭的艙位|頭艙
靠近|行埋
靠近邊緣|抆
靠過來|埋嚟
靠過去|埋去
靠邊兒的地方|邊邊
靠邊站|借歪
靠關係|掹衫尾
面不改色|面不改容
面世|出街
面具|鬼面罩
面子|薄面
面孔|面口
面容|口面
面有菜色|面青面黃
面生|生暴
面相|口面
面紅耳赤|面紅面綠
面紙|紙巾
面色|口面
面色難看|口黑面黑
面試|見工
面貌|口面
面貌醜陋的人|醜人
面頰上的酒窩兒|酒凹
靴子|靴
鞋匠|補鞋佬
鞋墊|鞋薦
鞋子太小|頂趾
鞋尖兒|鞋嘴
鞋尖|鞋嘴
鞋拔子|鞋抽
鞋掌|鞋碼
鞋的前掌|鞋掌
鞋跟|鞋㬹
鞋釘|鞋碼
鞋頭密封的鞋|密頭鞋
鞔|繃
鞦韆|韆鞦
鞭炮|炮仗
韭菜|快菜
音信|聲氣
音效|音樂
音樂唱片|音樂碟
音樂迷|樂迷
音色|聲線
音難讀|咬口
響鈴|打鐘
響|鋃
響飯|晏晝飯
頂住|牚
頂呱呱|冇得頂
頂嘴|駁嘴
頂|堂
頂多|最多
頂大用|頂硬檔
頂尖兒的影視明星|天王巨星
頂撞|村爆
頂替|頂檔
頂用|使得
頂級|頂級
頂腳趾頭|頂趾
頂腳|頂趾
頂讓|頂手
項鍊|頸鍊
項鏈|頸鏈
項飾|頸箍
順一方向拉或推|趟
順便說一句|順帶一提
順便|趁手
順利|就手
順勢|打鼓趁興
順勢趁勢|打蛇隨棍上
順口|口爽
順口溜|念口簧
順口答應而不去做|貪口爽
順延|褪
順得哥情失嫂意|左右做人難
順從|隨
順手|跟手
順杆爬|打蛇隨棍上
順桿兒爬|打蛇隨棍上
順桿爬|打蛇隨棍上
順當|順檔
順眼|合眼緣
順著撫埋|擸
順著|跟住
順藤摸瓜|藤掕瓜、瓜掕藤
順路|掂路
順路車|順風車
預備|預
預兆|意頭
預先做好|整定
預先斷定|睇死
預先準備|定
預先|預早
預料|預算
預期地|預期噉
預測的結果|貼士
預算|預
預訂|卜
預計到|批中
預計|預算
預設|前設
預調錄像|預校錄影
預防天花接種證明|痘紙
頑固|硬頸
頑皮|曳
頑皮死了|曳到死
頓|餐
頗佳|幾好
頗好|幾好
領了牌|有牌
領取執照不久|新牌
領取|拎
領口位置|領口位
領子|領
領導人|長
領導層|高層
領導者|頭
領導|阿頭
領工資|出糧
領帶|領呔
領悟暗示|醒神
領悟|醒水
領會|會意
領班|科文
領結|煲呔
領航員|帶水佬
領航|帶水
領著|湊着
領頭兒|做主
領頭|擔大旗
領頭者|阿頭
頦勒嗉|喉欖
頭一次|頭威頭勢
頭上無片瓦|冇瓦遮頭
頭上的毛|頭髮
頭上的泥垢|頭泥
頭兒|事頭
頭向下扎猛|插水
頭垢|頭泥
頭子|大哥大
頭屑|頭皮
頭昏昏然|暈陀陀
頭昏腦脹|頭大
頭暈|暈酡酡
頭暉腦漲|頭奅
頭有些暈|昏昏沌沌
頭朝下|打倒椗
頭期款|首付
頭班車|頭車
頭球|頭槌
頭疼腦熱|頭暈身熱
頭疼|頭刺
頭痛病|頭風
頭痛|頭刺
頭癬|瘌痢
頭皮屑|頭皮
頭目|阿頭
頭破血流|頭崩額裂
頭緒|首尾
頭腦不清醒|暈浪
頭腦不靈敏|吽
頭腦僵化|石屎頭腦
頭腦|心水
頭腦混沌|盲塞
頭腦清醒|心水清
頭腦發昏|暈
頭號女電影明星|一姐
頭銜|銜頭
頭頂上面|正中間
頭頂上|頭殼頂
頭頂|頭殼頂
頭頭兒|亞頭
頭頭是道|有頭有路
頭骨|頭殼
頭髮卡子|頭夾
頭髮呈旋渦狀處|轉
頭髮垂下|髧低
頭髮染成金色|金毛
頭髮梢|髮腳
頭髮由中間分縫兒|中間界
頭髮造型|恤髮
頭髮|頭毛
頻密|密密地
頻繁|頻密
頻道|台
頻頻|密密地
顆星星|粒星星
顆粒兒大|大粒
顆粒兒小|細粒
顏色|色
願不願意|䎺唔䎺
願意|䎺
願意接受|受落
顛倒是非|斬雞頭換雞腳
顛倒|調轉頭
顛簸|扽
類|隻
顧及|打理
顧客|客仔
顧家|傍家
顧左右而言他|講三講四
顧著|顧住
顧面子|顧面
顫動|趲
顫抖|揗
顯威風|威水
顯得|晒
顯現|出埋
顯眼的地方|當眼處
顯眼處|當眼處
顯眼|醒目
顯示實力|晒冷
顯示闊氣|擺闊佬
顯示|騷
顯能|焦即
顯貴|大粒
顯露在外|明
風乾|收乾水
風俗|俗例
風吹雨打|打風打雨
風寒|風邪
風帽|雪帽
風度|格
風水先生|風水佬
風涼話|唱口
風箏|紙鷂
風聲不對|勢色不對
風衣|風褸
風趣|攪笑
風雨交加|打風打雨
風雨橫掃|橫風橫雨
風雨衣|乾濕褸
風頭十足|威到盡
風馬牛不相及|大纜都扯唔埋
風騷蝕骨|姣屍扽篤
颱風警報|八號風球
颱風|風球
颳大風|打風
颳旋風|打旋風
颳風|返風
颳颱風|打颱風
飆|猋
飛快結婚|閃電結婚
飛快|飛腳
飛掠的聲音|嘬
飛機師|機師
飛機駕駛員|機師
飛行員|飛機師
飛行|飛
飛起腳踢人|飛腳
飛黃騰達|撈起
食具之一|筷子
食堂|飯堂
食欲|胃火
食水樣本|水樣
食物不嫩|老頇頇
食物腐敗變質|宿
食物該脆而不脆|蔫韌
食用油|食油
食量大|大食
食量小|細食
飢餓的人|餓貓
飯前|空肚
飯匙頭|飯鏟頭
飯團|壽司
飯店|酒樓
飯後|飽肚
飯桌|飯檯
飯桶|大食
飯盒|便當
飯碗兒|飯碗
飯碗|飯篼
飯糰|粢飯
飯量少|細食
飯鋪兒|食肆
飯鍋的蓋|飯蓋
飯鍋|飯煲
飯食|餐
飯館中的菜單|菜牌
飯館|食肆
飯餿|米漮
飲料|嘢飲
飲晒|喝光
飽和|爆
飽嗝兒|飽肊
飾邊|厘士
餅乾|曲奇
餅店|餅家
餅食一種|煙樨餅
養小老婆|包二奶
養樂多|益力多
養老院|安老院
養蜆的水塘|蜆塘
養豬的地方|豬欄
養豬|豬隻
餐廳|食肆
餐櫃|缽櫃
餐車|餐卡
餓肚子|扎炮
餓|肚餓
餓過了勁兒|餓過饑
餓過了頭|餓過肌
餘燼|火屎
餘額|剩低
餛飩|雲吞
餛飩麵條湯|雲吞麵
餿主意|屎橋
餿味|宿
餿|宿
餿臭|宿亨亨
饒舌|吱喳
饞嘴|為食
饞嘴鬼|為食貓
饞貓兒|為食貓
饞鬼|為食貓
首肯|肯制
首頁|頭版
香噴噴|夠鑊氣
香塔|塔香
香港人|港人
香港小姐|港姐
香港紙|港紙
香港總督|港督
香港貨幣|港紙
香港賽馬會|馬會
香港這個地方|香港地
香港|香港地
香滑軟熟|鬆化香口
香火|香燈
香灰|香爐灰
香煙|煙仔
香燭紙馬|元寶蠟燭
香皂|香梘
香精|香油
香腳|香笄
香腸|腸仔
香芋|檳榔芋
香草|臭草
香菜|芫茜
香菸|煙仔
香蕉水|天拿水
香蕉的一種|糯米蕉
香蕉|蕉
馬上|即刻
馬來西亞|大馬
馬利|馬里
馬大哈|大頭蝦
馬子|條女
馬尾做的拂塵|塵拂
馬屁的人|擦鞋仔
馬拉威|馬拉維
馬桶|屎塔
馬櫻丹|臭花
馬爾地夫|馬爾代夫
馬糞紙|紙皮
馬虎了事|沙沙滾
馬虎大意|大懵
馬虎|欺場
馬蜂|黃蜂
馬賽克|紙皮石
馬路上的自來水管|街喉
馬路邊兒|街邊
馬路邊|馬路面
馬達|摩打
馬鈴薯|荷蘭薯
馬面魚|剝皮牛
馬面魨|剝皮牛
馬馬虎虎|麻麻地
馬駒兒|馬仔
馬駒子|馬仔
馬齒莧|瓜子菜
馴服|帖服
馴良|馴品
駐足|褸
駕照|車牌
駕駛執照|車牌
駕駛|駛
駛至|駛到
駛進|駛入
駝背|寒背
駝色|啡色
騎牆的人|兩頭蛇
騎牆者|兩頭蛇
騎自行車|踏單車
騎|踩
騎馬跑碎步|跑花蹄
騙人|搵丁
騙人的媒人|媒人棍
騙吃騙喝|黐飲黐食
騙|呃
騙子|光棍
騙財物|起尾注
騙賣|賣豬仔
騙錢|掠水
騰空了|交吉
騰騰|淋淋聲
騷擾|滋擾
驅趕|趯
驅逐|拍
驅騎|策騎
驕傲|大枝嘢
驕傲而輕浮|沙塵白霍
驕傲自大|沙塵白攉
驚心動魄|鼻哥窿冇肉
驚恐|發矛
驚慌|驚青
驚懼|失魂
驚覺|扎
驚醒|扎醒
驚險|驚嚇
驟雨|白撞雨
骨氣|硬氣
骨灰|靈灰
骨瘦如柴|膝頭大過髀
骨節關|骹
骨關節|骹
骨頭|骨
骯髒的孩子|污糟貓
骯髒的東西|污糟嘢
骯髒|邋遢
骰子|色仔
骷髏頭|死人骨
骷髏|骷髏骨
髒亂|污哩馬查
髒字|粗口
髒汙|汙穢
髒|烏糟
髒話|粗口
髒鬼|烏糟貓
體力|體能
體型矮小|細粒
體己錢|私己
體弱多病的人|病君
體弱畏寒|寒底
體弱而虛胖|倒囊
體形|件頭
體念|乃念
體操|操
體溫表|探熱針
體溫計|探熱針
體胖而壯|肥屍大隻
體面|企理
髕骨|菠蘿蓋
高低不平|好碞磛
高個兒|大隻
高個子|高佬
高傲|高竇
高價|貴價
高利|貴利
高利貸者|大耳窿
高利貸|貴利
高品質|高質
高壓水槍|水炮
高壓水龍|水炮
高壓水龍頭|水炮
高壓鍋|高壓煲
高大健壯|大隻累累
高大威武|高大威猛
高大|神高神大
高大英俊|高大威猛
高山梨|雪梨
高峰|新高
高強的本領|飛天本事
高手|㔹人
高招|好橋
高明|上算
高水平的歌曲|金曲
高深的本領|道行
高湯|上湯
高漲|高企
高爾夫球|地波
高的瓦鍋|企身煲
高筒雨鞋|水靴
高粱米|高粱粟
高粱|高粱粟
高級官員|高官
高級宴席|大餐
高興|歡喜
高舉|打正
高跟鞋|高㬹鞋
高金屬直身大鍋|鐺
高高聳立|高洞洞
高高興興|開開心心
高高|高洞洞
高麗菜|椰菜
髮卡|頭夾
髮夾子|頂夾
髮梢|髮尾
髮網|髮笠
髮蠟|頭蠟
髮邊|髮腳
髮髻|髻
髮鬢|滴水
鬆弛歪斜|撝
鬆散|甩
鬆散的樣子|散修修
鬆緊帶|橡筋
鬆脆餅|克力架
鬆脆|鬆化
鬆軟|削
鬆軟噴香|鬆化香口
鬆開|放
鬆餅|班戟
鬆鬆散散|散修修
鬈毛|攣毛
鬈髮|攣毛
鬍子刀|鬚刨
鬍子|鬚
鬍鬚|鬚子
鬢腳|髮腳
鬢角|䄪穗
鬥一下|鬥一番
鬥一鬥|鬥一番
鬥個你死我活|鬥到七彩
鬥智場面|鬥智橋段
鬥智情節|鬥智橋段
鬥智|鬥八寶
鬥氣|拗氣
鬥法寶|鬥八寶
鬥法|鬥八寶
鬥眼兒|鬥雞眼
鬥蟋蟀用的草|蟀草
鬥魚|花手巾
鬧事|搞搞震
鬧事者|攪屎棍
鬧個不停|嘈嘈閉
鬧別扭|鬥負氣
鬧哄哄|嘈喧巴閉
鬧彆扭|鬥負氣
鬧成一團|胡天胡帝
鬧新房|玩新人
鬧水災|水浸
鬧洞房|玩新人
鬧着玩兒|貪得意
鬧翻了臉|爛口爛面
鬧翻天|嘈喧天
鬧脾氣|使頸
鬧著玩兒|柴哇哇
鬧著玩|詐假意
鬧|貪得意
鬧騰|囉囉攣
鬱悶|閉翳
鬼哭狼號|喂哇鬼叫
鬼壓牀|畀鬼笮
鬼心眼多|多計
鬼故事|鬼故
鬼|為食貓
鬼的故事|鬼古
鬼祟|鬼鼠
鬼迷心竅|着鬼迷
鬼靈精|鬼馬
鬼頭鬼腦|思思縮縮
鬼鬼祟祟|鬼鼠
鬼魂纏身|鬼上身
鬼魂|鬼
魁偉|大隻
魁梧|大隻
魂陋|鶻突
魂飛魄散|失魂
魔方|扭計骰
魔法|茅山法術
魔術|耍把戲
魚丸粉麵|魚蛋河
魚丸|魚蛋
魚子|魚春
魚漿|魚滑
魚白|魚獲
魚的精囊|魚臒
魚肉丸子|魚蛋
魚肉敗壞|葾
魚肉泥|魚滑
魚肉糜|魚茸
魚肝油|魚油
魚腦|魚雲
魚腹部之肉|魚腩
魚苗|魚花
魚蝦等的卵|子
魚販|賣魚佬
魚鰾|魚白
魯莽|鶻突
魷魚乾兒|土魷
鮐|池魚
鮪魚|吞拿魚
鮭魚|三文魚
鮮奶油|忌廉
鮮的銀魚|白飯魚
鮮美|鮮甜
鮮|鮮甜
鯔|烏頭
鯪魚|土鯪魚
鯰魚|塘虱
鰨目魚|笪沙魚
鰱魚|扁魚
鰹魚|柴魚
鰻|風鱔
鱉|水魚
鱒魚|大眼雞
鱔|長魚
鱖|桂花魚
鱧|生魚
鱷梨|牛油果
鳥七八糟|林沈
鳥兒|雀仔
鳥名|鷯哥
鳧|野水鴨
鳳仙花|燈盞花
鳳尾魚|馬鱭魚
鳳梨|波蘿
鳳眼果|頻婆
鳴鐘|打鐘
鳶|麻鷹
鴇母|龜婆
鴉片煙|煙
鴨兒梨|鴨嘴梨
鴨子|鴨仔
鴨梨|雪梨
鴨殼|鴨朴
鴨絨的舊稱|鶴絨
鴨肫|鴨腎
鴨舌帽|鴨咀帽
鴨骨架|鴨扑
鴿子|白鴿
鵝卵石|鵝春石
鵝的一種|獅頭鵝
鵝蛋形的臉|鵝蛋口面
鵝蛋臉形|瓜子口面
鵝蛋臉|瓜子面
鶴嘴鎬|啄
鷂鷹|麻鷹
鷹釣鼻子|鸚哥鼻
鷹|麻鷹
鹵鴨|鹵水鴨
鹹|咸
鹹水草|水草
鹹濕|鹹
鹹菜的一種|菜頭
鹹蘿蔔乾|蘿蔔潤
鹹酸菜|鹹菜
鹹魚又復活了|鹹魚翻生
鹽味|鹹
鹽腌姜片|鹹姜
鹽腌姜絲|鹹姜
鹽腌的蘿蔔條|菜脯
鹿的初生角|茸
麝香鴨|番鴨
麥克風|咪頭
麥片|麥粉
麥當勞|麥記
麥粒腫|眼挑針
麵人兒|粉搓公仔
麵包|包
麵包車|保姆車
麵條|麵
麵|麪
麻利|爽手
麻包的大針|包針
麻子|痘皮
麻將牌|麻雀
麻將|麻雀
麻木|痹
麻煩事|手尾
麻煩多|一身蟻
麻煩很多的人|多事古
麻煩您|唔該
麻煩|澀滯
麻煩"|茶煲
麻|痹
麻痹|痹
麻瘋病人|本地狀元
麻糬|糯米滋
麻雀|禾雀
黃乎乎|黃黚黚
黃包車|手車
黃昏|挨晚
黃曆|通勝
黃梅天|梅雨天
黃梅雨季節|雨水天
黃油|牛油
黃狗毛|黃狗頭
黃瓜|青瓜
黃米|黃粟
黃色|三級
黃芽菜|黃芽白
黃螞蟻|黃絲蟻
黃蠟|蜜蠟
黃豆|白豆
黃豆芽|大豆芽
黃赤色的螞蟻|黃絲蟻
黃醬|麵豉
黃金|金
黃雀|相思
黃面婆|老藕
黃頭髮|黃毛
黃黃|黃黚黚
黍子|黃粟
黎明|天曚光
黏住|黐實
黏土|泥膠
黏在身上的膏藥|黐身膏藥
黏液|潺
黏糊糊的|好𥹉
黏糊|黐牙
黏連|孖
黏黏糊糊|唔嗲唔吊
黏黏|黏黏哋
黏|黐
黑不溜秋|黑古勒特
黑人|黑鬼
黑咕隆咚|黑麻麻
黑咖啡|齋啡
黑咪麻|黑麻麻
黑小子|黑炭頭
黑市勞工|黑工
黑幫頭目|江湖大佬
黑得好看|烏卒卒
黑板擦子|粉擦
黑桃|葵扇
黑橄欖核中的仁|欖仁
黑沉沉|烏卒卒
黑洞洞|黑麻麻
黑漆漆|烏黢黢
黑燈下火|烏燈黑火
黑燈瞎火|烏燈黑火
黑痣|墨
黑白棋|蘋果棋
黑眼圈|熊貓眼
黑眼鏡|盲公鏡
黑着臉|黑口黑面
黑社會中人|黑道中人
黑社會的背景|黑底
黑社會的頭目|大佬
黑社會頭目|江湖大佬
黑種人|黑鬼
黑糊糊|黑瞇萌
黑色|青
黑色顏料|烏煙
黑茫茫|黑咪麻
黑蒙蒙|烏卒卒
黑話|背語
黑豆|烏豆
黑間|夜晚黑
黑魚|生魚
黑黑|烏卒卒
黑黝黝|烏卒卒
默寫|背默
黝黑|黑𪓷𪓷
點兒|咁多
點單|落單
點子|橋
點心|小食
點心皮|酥皮
點火兒就著|炮仗頸
點火|開爐
點燃|放
點破|點
點綴節日|應節
點菜來吃|嗌嘢食
點菜|落單
點著|透爐
點選|撳
點頭|岌頭
點點累積|層層疊上
鼓出|凸
鼓動|嘍
鼓勵|力撐
鼓起來|凸
鼓起|凸
鼓起腮幫子|鼓埋泡腮
鼓面|鼓皮
鼓鼓囊囊|脹卜卜
鼠摸|墨七
鼻塞|盲鼻
鼻子不通氣兒|盟鼻
鼻子不通|鼻塞
鼻子底下有嘴|口在路邊
鼻子|鼻哥
鼻孔大|奓鼻
鼻孔|鼻哥窿
鼻挺|鼻水
鼻梁平直|通關鼻
鼻涕凝結物|鼻屎
鼻涕|鼻水
鼻眼兒|鼻哥窿
鼻翅寬|奓鼻
鼻青臉腫|口腫面腫
鼻音重|盲鼻
鼻鼾聲|括括聲
齁兒|剌
齁嗓子|戟喉
齁甜|甜嘢嘢
齊備|有齊
齊全了|夠晒數
齊全|有齊
齊|夠數
齊截|歸一
齋姑吃的素食|清齋
齋料|齋菜
齒齦|牙肉
齜牙|哨牙
龍喉|龍頭
龍捲風|鬼旋風
龍眼肉|圓肉
龍舟比賽|鬥龍船
龍舟|龍船
龜兒子|龜仔
龜孫子|契弟
