!|！
"|
,|，
.|。
:|：
;|；
?|？
a|
i|我
m|公尺
,-|、
-`|」
;;|;
`-|「
an|
as|做為
at|於
by|由
cc|副本
cm|公分
cw|順時針
db|資料庫
do|做
ga|格語
go|前往
id|識別號
if|如果
in|於
it|它
me|我
mm|公釐
my|我的
no|沒有
of|之於
ok|確定
on|於
or|或
os|作業系統
so|因而
to|到
up|向上
we|我們
yi|彝文
"to|要
(c)|©
-be|是
-do|嗎
-en|的
-ly|地
...|…
a "|A
ace|王牌
adc|類比和數位轉換器
add|加入
age|老化
ago|之前
aid|救助
aim|瞄準
aka|亦即
all|所有
and|與
any|任何
app|應用軟體
apr|四月
arc|弧
arm|手臂
art|圖案
ask|詢問
aug|八月
avg|平均
bad|不當的
bar|桿
bay|槽
bcc|密件副本
bed|床
big|大
bit|位元
bof|同類聚
box|框
bug|錯誤
bus|匯流排
but|但是
buy|購買
bye|再見
can|可以
cap|帽
car|汽車
ccw|逆時針
cf.|參看
cow|牛
crc|循環冗餘檢查
cut|剪下
dao|資料存取物件
day|天
dde|動態資料交換
ddl|資料定義語言
dec|十二月
dht|分散式雜湊表
die|消滅
dim|調暗
dir|目錄
dll|動態鏈結函式庫
dos|DOS
dot|點
dsn|資料來源名稱
due|到期
ear|耳
edo|艾鬥語
eg.|例如：
egg|蛋色
end|結束
era|年代
ewe|埃維語
eye|眼
fan|風扇
faq|常見問題
fat|FAT 檔案分派表
fax|傳真
feb|二月
fee|費用
few|幾個
fit|吻合
fix|修正
fog|霧化
fon|豐語
for|用於
fps|影格/秒
frm|影格
ftp|檔案傳輸通訊協定
fun|娛樂
gap|間隙
gas|氣體
get|獲得
gnu|革奴
goa|果阿風格
got|得到
gui|圖形使用者介面
han|漢字
hex|十六進位
hi,|嗨，
his|他的
hit|點擊
hop|躍點
hot|熱門
how|如何
hub|集線器
hue|色相
i/o|輸入輸出
ide|整合開發環境
ido|伊多語
ini|INI
ink|油墨
ins|插入
int|整數
its|其
jan|一月
jar|JAR 檔案
jcl|工作控制語言
jdb|爪哇除錯程式
job|工作
jog|慢放
jul|七月
key|鍵
kip|基普
kit|工具組
kvp|尖峰電壓仟伏
lag|滯後
lao|寮語
law|法律
lay|紙規
leg|腿
lek|列克
len|長度
let|讓
log|記錄檔
low|低
lum|照度
luo|盧奧語
map|映射
mar|三月
max|最大
may|也許會
mci|多媒體控制介面
mdi|多重文件介面
min|最小
mix|混合
mro|姆盧文
mru|姆盧語
n/a|無法提供
net|網路
new|新
nil|零
nni|網路節點介面
no"|否
no.|號碼
non|非
not|無法
nov|十一月
now|現在
nut|螺帽
oct|十月
odd|奇數
off|關閉
oh,|噢，
old|舊的
one|一個
oop|物件導向程式設計
opc|最佳功率校測
osi|開放系統互連
our|我們的
out|出
own|本身
pad|填充
pay|付款
pel|像素
pen|畫筆
per|各
pig|猪
pin|接腳
pma|光碟記錄暫存區
pop|流行
put|置放
ram|記憶體
rap|饒舌
raw|原始
rdo|遠端資料物件
red|紅色
rgb|紅綠藍
roa|認可之營運機構
rom|唯讀記憶體
row|列
run|運行
sar|信號雜訊比
saw|發現
say|表示
see|參看
sep|九月
set|設定
ska|斯卡風格
sky|天空
snr|信號雜訊比
sol|索爾
spy|靜態分割視窗
ssn|社會保險號碼
sub|子
sum|和
tab|頁籤
tag|標籤
tai|台語
tan|正切函數
tap|戳
tar|打包
tax|稅
ten|十
the|
tip|祕訣
tiv|提夫語
to:|收件者：
toc|光碟內容表
too|太
top|頂
try|嘗試
twi|奇族語(迦那)
two|兩
uae|阿聯酋
uni|使用者網路間介面
url|網址
usa|美國
use|使用
vai|瓦伊文
vbr|變動位元率
via|透過
way|方式
web|網頁
who|誰
why|為什麼
won|勝利
yao|瑤語
yen|日圓
yes|是
yet|未
you|您
"and|並且
"cjk|中日韓
"fri|週五
"get|提取
"jun|六月
"may|五月
"mon|週一
"new|新建
"on"|開
"out|發信匣
"sat|週六
"sun|週日
"tab|跳格鍵
"thu|週四
"top|頂端
"tue|週二
"wed|週三
%s's|%s 的
, as|，因為
-ing|中
...]|…]
2 nd|第二
a.m.|上午
abut|緊靠
acid|酸
acls|存取控制列表
acre|英畝
afar|阿法爾語
ahom|阿豪姆文
aids|輔助
ainu|阿依努語
akan|迦納語
all"|全部
also|也
amid|摻入
ansi|ANSI
anti|抗
apex|頂角
aqua|青色
arab|阿拉伯
arcs|圓弧
area|區域
args|引數
arts|文章
as a|做為
atom|原子
atop|置頂
aunt|嬸姨
auto|自動
away|暫離
axes|軸
axis|軸線
back|上一步
baht|泰銖
ball|球
band|帶
bank|銀行
bare|裸
bark|樹皮
basa|巴薩語
base|基底
bass|低音
baud|鮑
beak|喙
beat|節拍
beep|鳴聲
bell|響鈴
belt|皮帶
bend|彎曲
best|最佳
beta|測試版
bias|偏差
bill|賬單
bind|繫結
bird|鳥
blin|比林語
blip|光點
blob|斑點
blog|部落格
blue|藍色
blur|模糊
boat|船
body|內文
bold|粗體
book|書籍
boom|暴漲
boot|開機
born|出生
both|兩者
bowl|弧筆
braj|布拉吉語
brim|邊緣
bulb|燈泡
bulk|堆積艙
bump|凸塊
burn|燒錄
bury|埋藏
busy|忙碌
butt|酒桶
byte|位元組
call|呼叫
calm|鎮靜
camp|營區
cape|收發器
card|卡
care|關照
case|大小寫
cast|演員陣容
cd-r|光碟燒錄機
cedi|塞地
cell|儲存格
chad|查德
cham|占文
char|字元
chat|聊天
chip|晶片
cite|引用
city|城市
clip|裁剪
club|俱樂部
code|編碼
coin|錢幣
cone|圓錐體
cook|庫克
copy|拷貝
core|核心
cost|成本
cove|拱形
cram|填塞
cree|克里語
crew|人員
crop|裁剪
cuba|古巴
cube|立方體
cult|狂熱崇拜
cusp|尖頭
cyan|青色
daas|桌面即服務
dark|陰暗
dash|破折號
data|資料
date|日期
dear|敬愛的
deck|卡片組
deem|認為
deep|深刻的
demo|演示
deny|拒絕
dial|撥號
dice|骰子
disc|碟片
disk|磁碟
dock|停駐
done|完成
dong|盾
door|匣門
down|向下
drag|拖曳
draw|繪製
drip|水滴
drop|掉失
drum|磁鼓
dual|雙
duct|輸送管
duet|二重奏
dump|傾印
duty|職責
e.g.|例如：
each|每個
ease|容易度
east|東
easy|容易
echo|回應
edge|邊緣
edit|編輯
efik|埃菲克語
else|不然就
esp.|尤其
etc.|等等…
etch|刻蝕
euro|歐元
even|即使
ever|曾經
exit|退出
face|字體
fade|淡變
fail|失敗
fake|假造
fang|芳語
fast|快速
feed|饋送
feet|英尺
fiji|斐濟語
file|檔案
fill|填充
film|軟片
find|尋找
fine|細緻
fire|引發
fish|魚
five|五個
flag|旗標
flap|蓋板
flat|扁平
flea|跳蚤
flex|屈曲
flip|翻轉
flow|流程
fold|摺疊
folk|民歌
font|字型
food|食物
foot|英尺
fork|叉生
form|表單
four|四
free|自由
from|從
fula|富拉語
full|全部
fund|資助
funk|放克
fval|未來值
gain|取得
game|遊戲
gang|幫
gate|閘
gayo|卡約語
geek|怪傑
geez|吉兹語
gift|禮物
give|賦予
glow|光暈
glue|黏合
goal|目的物
gold|金
golf|高爾夫
good|良好
goto|前往
grab|抓取
gray|灰色
grey|灰色
grid|格線
grip|握把
grow|增長
guam|關島
gulf|波斯灣
hair|頭髮
half|半
halo|光暈
halt|停機
hand|手
hang|掛機
hard|硬式
harm|損害
hash|雜湊
head|前端
heap|堆積
heat|熱力
heed|聽從
held|延遲
help|說明
here|這裡
hide|隱藏
high|高
hint|提示
hits|吻合項目
hold|暫停
hole|漏洞
home|個人資料夾
hood|外套
hook|攔截
hope|希望
host|主機
hour|時
huge|超大
huh?|是吧？
hung|宕機
hupa|胡帕語
i'll|我將
i.e.|也就是
iban|伊班語
icon|圖示
idea|主意
idle|閒置
igbo|伊布語
in."|英吋
inch|英吋
info|資訊
into|進入
iran|伊朗
iraq|伊拉克
iron|鐵
isdn|整體服務數位網路
isup|整體服務數位網路用戶部
it's|
item|項目
jack|插座
jail|囚牢
jamo|韓文字母
java|爪哇
jazz|爵士
join|聯結
jpop|日式流行音樂
july|七月
jump|跳躍
june|六月
junk|垃圾
just|僅
kana|假名
kawi|卡威語
keep|保持
kern|字間微調
keys|索引鍵
kick|踢出
kill|砍除
kina|基那
knot|結
know|知道
komi|科米語
koro|科羅語
kyat|緬甸元
lace|蕾絲
lack|欠缺
lame|跛
laos|寮國
last|最後一筆
lazy|緩式
leaf|葉
lean|羽量
leap|躍
left|向左
lens|鏡片
less|更少
life|生命
lift|舉起
like|如同
lime|亮綠
line|列
link|鏈結
lint|梳理
lips|嘴脣
lira|里拉
list|列表
lisu|傈僳語
live|即時
load|載入
loan|借貸
lobe|輪瓣
lock|鎖住
logo|標章
loma|洛馬語
lone|孤立
long|長
look|外觀
loop|迴圈
lose|遺失
loss|失真
lost|失去
love|喜愛
lozi|洛齊語
luck|運氣
lung|肺部
made|所做
mail|郵件
main|主要
make|製作
mali|馬利
manx|馬恩語
many|許多
mari|馬里語
mark|標記
mask|遮罩
mass|大量
math|數學
max.|最大
maze|迷宮
mean|平均
meme|彌因
memo|備忘錄
menu|選單
mesh|網面
mess|困境
meta|中繼
miao|滇東北老苗文
mice|滑鼠
mild|溫和
mile|英里
milk|牛奶
mine|我的
mini|迷你
misc|雜項
miss|缺少
mite|蟎
mode|模式
modi|莫迪文
mold|鑄型
mono|單音
moon|月亮
more|更多
most|最
move|移動
much|太多
must|必須
mute|靜音
n'ko|西非書面語
name|名稱
navy|海軍藍
near|接近
need|需要
nerd|怪傑
nest|巢狀
news|新聞
next|下一個
nias|尼亞斯語
nice|好
nick|凹部
niue|紐埃
node|節點
none|無
noob|菜鳥
noon|中午
norm|正規化
note|註記
noun|名詞
null|空值
obey|遵守
okay|沒問題
old"|舊
oman|阿曼
omit|省略
once|一旦
only|衹有
onto|到
oops|哎呀
open|開啟
oral|口頭
over|之上
p.m.|下午
pace|步調
pack|包裝
page|頁面
paid|付款
pair|對
pali|巴利語
pane|窗格
part|部分
pass|回合
past|過去
path|路徑
peak|尖峰
pedi|北方索托語
peer|對等點
peru|祕魯
peso|披索
pica|12 點
pick|揀取
pies|圓
pike|梭子魚
ping|知會
pink|粉紅
pipe|管線
plan|方案
play|播放
plug|插接
plum|梅紅
plus|加上
poem|詩
pole|極
poll|意見調查
port|通訊埠
post|貼文
pour|傾注
prev|上一個
puck|圓盤
pula|普拉
pump|泵浦
punk|龐客
push|推
qcnt|量子數
quit|離開
race|競速
rain|雨
ramp|斜面
rand|蘭特
rank|等級
rate|比率
rave|銳舞音樂
read|讀取
real|真實
reap|清除
redo|再做
reed|蘆葦
reel|捲盤
rest|其餘的
rial|里亞爾
rich|貴重
ride|騎乘
ring|環
risk|風險
road|路
rock|搖滾樂
role|角色
roll|滾動
room|房間
root|根
rose|玫瑰紅
rsvp|回覆確認
ruby|紅寶石
rule|規則
rung|階
saba|薩巴
sack|組合
safe|安全
sale|銷售
same|相同
sami|薩米語
sane|合理
save|儲存
scam|騙局
scan|掃描
seal|印鑑
secs|秒
seed|種子
seek|尋取
seem|似乎
seen|看見
send|發送
sent|已發送
sets|集合
shan|撣語
ship|出貨
show|顯示
side|側邊
sign|符
silo|孤立
sine|正弦
sink|槽
site|站臺
size|大小
skew|歪斜
skim|瀏覽
skin|外觀
skip|跳過
slab|厚片
slim|微薄
slit|工具條
slot|插槽
slow|慢
slug|名條
snap|貼齊
snow|雪白
soft|軟式
sold|販售
solo|獨唱
some|某些
song|歌曲
soon|快點
sort|排序
soul|靈魂樂
spam|垃圾信
spot|斑點
spur|棱筆
star|星型
stay|保持
std.|標準
stem|字根
step|步驟
stop|停止
stub|樁腳
stud|螺栓
such|這類
suck|爛
suez|蘇伊士
suit|合適
susu|蘇蘇語
sutu|蘇土語
swap|交換
syli|西里
sync|同步
tail|尾端
taka|塔卡
take|需
tala|塔拉
tall|高
tape|磁帶
task|工作項目
taxi|計程車
teal|藍綠
team|團隊
tell|告訴
tend|接近
term|用語
test|測試
text|文字
thai|泰語
than|比
that|該
them|它們
then|然後
they|它們
thin|細薄
this|這個
thus|因而
tick|刻度
tier|階層
tile|並排
tilt|斜度
time|時間
tint|色調
tiny|微小的
togo|多哥
tone|按鍵式電話
too"|也
took|耗用
tool|工具
tour|遊覽
trap|陷阱
tray|托盤
tree|樹
trim|修剪
trip|旅程
true|真
tube|管子
tune|調校
turn|輪值
type|類型
ugly|難看的
undo|復原
unit|單位
upon|當
urdu|烏爾都語
used|已用
user|使用者
vamp|修補
vary|形形色色
verb|動詞
very|很
veto|否決
view|檢視
void|虛值
vote|投票
wait|等待
wake|喚醒
walk|走訪
wall|牆
wand|魔杖
want|想要
warm|溫暖
warn|警告
warp|回轉
waxy|蠟狀
weak|弱
week|週
well|得不錯
went|了
west|西
what|什麼
when|時
wide|寬
will|將
wind|旋緊
wink|眨眼
wipe|擦拭
wire|線路
wise|明智
wish|希望
with|與
wood|木頭
word|字詞
work|作用
wrap|換列
yank|拔
year|年
your|您的
zero|零
zone|區
zoom|縮放
zulu|祖魯
zuni|祖尼語
"beat|打擊樂
"help|求助
"left|左側
"old"|舊有
"tabs|頁籤
"type|輸入
"when|當
(e.g.|(例如：
(i.e.|(亦即
, and|，而
, col|，行
-have|有
8-bit|8 位元
a bit|一點
a new|新的
abaza|阿巴札語
abort|放棄
about|關於
above|以上的
acoli|阿喬利語
acute|銳角
adapt|調整
added|加入
adder|加法器
admin|管理
adopt|採用
adult|成人
afaka|阿法卡文字
after|之後
again|再次
agent|代理程式
agile|敏捷
aging|時效
alarm|警示
album|專輯
alert|警示
aleut|阿留申語
alias|別名
align|對齊
alive|活動狀態
allow|允許
alone|單獨
along|沿著
alpha|阿法
altai|阿爾泰語
alter|改變
amber|琥珀
amend|修正
among|之中
angle|角度
anime|動漫歌曲
apple|蘋果
apply|套用
april|四月
arise|發生
array|陣列
arrow|箭頭
aruba|阿魯巴
as if|如同
as is|原樣
aside|放著
asset|資產
attr.|屬性
audio|音訊
audit|稽核
avoid|避免
await|等待
axial|軸向
azeri|阿澤里語
azure|天藍白
badge|徽章
bamum|巴姆穆語
bantu|班圖語
basic|基本
basis|基礎
batak|巴塔克語
batch|批次
baton|權杖
be no|並非
be to|是要
bebob|比波普爵士
begin|開始
beige|米黃
below|以下的
bemba|本巴語
benin|貝南
bevel|斜角
bikol|比科爾語
bilin|比林語
black|黑色
blade|刀鋒
blank|空白
blaze|照亮
bleed|榨取
blend|混成
blink|閃動
block|區塊
blues|藍調
blurb|推薦語
board|板
boast|自豪
bogus|假造的
boids|群聚
bokeh|散景
bonus|紅利
boost|推動
botch|補丁
bound|約束
boxed|加框
brace|括號
brand|商標
brave|抑音符
break|中斷
breve|短音符
brief|簡要
bring|帶
broad|廣泛的
brown|棕色
brush|筆刷
buddy|人偶
buhid|布黑德語
build|組建
bully|欺負
bumpy|隆起的
burma|緬甸
burst|猝發
by us|由我們
cabin|艙房
cable|連接線
cache|快取
caddo|卡多語
cadet|軍校生
canal|運河
caret|插字符號
carry|攜帶
catch|抓到
cause|造成
cd-rw|可讀寫光碟機
cease|終了
chain|鏈接
chart|圖表
check|檢查
chewa|切瓦語
child|子項
chile|智利
china|中華
chord|套索
chunk|資料塊
cigar|雪茄
cirth|精靈－色斯文
claim|宣稱
clamp|箝制
clash|抵觸
class|類別
clean|清潔
clear|清空
click|按一下
cliff|懸崖
clips|剪影
clock|時鐘
clone|複殖
close|關閉
cloud|雲
clump|聚
cocos|科科斯
codec|編碼解碼器
colon|科郎
color|顏色
comet|慧星
comma|逗號
congo|剛果
const|常數
coral|珊瑚紅
could|可能
count|計數
cover|封套
crane|升降
crash|崩潰
crawl|爬行
crazy|瘋狂
cream|淡奶油色
creek|克里克語
cross|交叉
curve|曲線
cyber|數碼
cycle|周期
czech|捷克語
daily|每天
daisy|雛菊
dally|虛耗
dance|舞曲
dayak|達雅
debit|借方
debug|除錯
decay|衰敗
defer|延緩
delay|延遲
delta|差異
demon|守護程式
depth|深度
digit|數位
dinar|戴納
dinka|丁卡語
diode|二極體
disco|迪斯可
do so|這樣做
dodge|加亮
dogri|多格拉語
dolby|杜比
dolly|推拉
donor|捐贈者
draft|草稿
drain|排放
drama|戲劇
drawn|拉出
dream|夢幻
drift|漂移
drive|碟片機
druid|精靈程式
duala|杜亞拉語
dummy|虛設
dutch|荷蘭語
dyula|迪尤拉語
eager|急式
early|早期
egypt|埃及
eject|退片
elide|略去
email|電子郵件
embed|內嵌
emoji|繪文字
empty|清空
enjoy|享受
enter|輸入
entry|條目
epoch|時期
eprom|可抹除可程式唯讀記憶體
equal|等於
erase|抹除
error|錯誤
erzya|厄爾兹亞語
etc..|等等…
event|事件
every|每
exact|精確的
exert|運用
exist|存在
extra|額外
facet|平面
facts|短註
faith|信仰
false|假
fancy|花俏
fanti|芳蒂語
farsi|伊朗語
fatal|嚴重
fault|失誤
favor|偏好
fetch|擷取
fewer|更少的
field|欄位
fiery|火紅色
fifth|第五
filed|歸檔
final|最後的
fine,|不錯，
finer|更細緻
first|先
fixed|固定的
fixme|待修正
fixup|修正
flame|火焰
flesh|肉
float|浮點數
flood|滿溢
floor|底板
fluid|溶液
flush|沖寫
flyer|傳單
focus|焦點
folio|摺頁
force|強制
forum|論壇
found|找到
frame|影格
franc|法朗
fresh|重新
from:|寄件者：
front|正面
frown|皺眉
fully|完全地
funds|資金
fungi|真菌
funky|生澀的
funny|怪怪的
fuzzy|模糊
gabon|加彭
gamma|伽瑪值
gamut|全音階
ganda|干達語
gauge|量表
gbaya|巴亞語
genre|類型
ghana|迦納
given|給定的
glyph|字圖
gnome|地精
go to|前往
gondi|貢德語
goods|貨物
grain|顆粒
grand|大
grant|授與
grape|葡萄色
graph|圖學
grass|草地
grave|抑音符
great|很棒的
grebo|格列博語
greed|貪婪
greek|希臘語
green|綠色
group|群組
grove|樹叢
grown|增長
guess|猜測
guest|訪客
guide|指導
haida|海達語
haiti|海地
handy|好用
hanja|漢字
happy|快樂
hatch|孵化
hausa|豪撒語(蘇丹)
heavy|沉重
hello|哈嘍
hence|因而
hindi|印地語
hmong|苗語
horse|馬
hours|小時
house|屋室
hover|停留
human|人類
humor|幽默
hypha|菌絲
ideal|理想的
iloko|伊洛卡諾語
image|影像
imply|隱含
in it|其中
in kb|單位 KB
inbox|收件匣
index|索引
india|印度
indic|印度
indie|獨立製作
indus|印度
inert|惰性
inker|油墨物質
inlay|鑲套
inner|內
input|輸入
inset|內縮
inter|幅間
intro|簡介
ionic|離子
irish|愛爾蘭語
issue|疑難
italy|義大利
ivory|象牙白
japan|日本
jiffy|剎那
johab|雙位元組合型符號
kamba|卡姆帕語
kanji|漢字
karma|業力
kazak|哈薩克族
kenya|肯亞
khaki|卡其色
khasi|卡西語
khmer|高棉語
kiosk|自動化服務機
knife|美工刀
known|已知
kongo|剛果語
korea|韓國
krona|克朗
kumyk|庫梅克語
label|標貼
labor|勞力
lamba|蘭巴語
lanna|蘭納文
lapse|流逝
large|大
laser|雷射
lasso|套索
latch|鎖存
later|稍後
latin|拉丁字母
layer|圖層
learn|學習
lease|使用期
leave|離去
legal|合法的
leone|利昂
level|層級
lever|導桿
lexer|詞彙分析器
libya|利比亞
liege|列日
light|細體字
lilac|淡紫
limbu|林布語
limit|限制
liner|規範器
linus|林納斯
litho|平板
lo-fi|低傳真
local|本地
login|登入
logon|登錄
loose|失去
loser|輸家
lossy|失真的
lower|降低
lunda|隆達語
lyric|歌詞
macao|澳門
macau|澳門
macro|巨集
magic|魔術
mains|主電源
maize|玉米色
major|主要的
maker|自造者
makes|使得
malay|馬來語
malta|馬爾他
maori|毛利語
march|三月
masai|馬塞語
match|符合
matte|色版
mauve|鮮紫
mayan|馬雅語
maybe|也許
means|表示
media|媒體
meets|合乎
mende|門德語
mercy|慈悲
merge|合併
meta"|後設資料
metal|金屬
meter|公尺
metre|公尺
might|也許
minor|次要
misc.|雜項
miter|斜接
mitre|斜面
mixer|混音器
modal|強制回應
model|式樣
modem|數據機
modul|模數
monad|單子
money|金錢
mongo|芒戈語
month|月
morph|變形
mossi|莫西語
mould|模型
mount|掛載
mouse|滑鼠
movie|影片
multi|多重
music|音樂
mutex|互斥
naira|奈拉
named|具名的
nauru|諾魯
nepal|尼泊爾
never|永遠不會
newer|較新
next"|下一步
nifty|俏皮
niger|尼日
night|夜
ninth|第九
noble|貴重
nogai|諾蓋語
noise|雜訊
nonce|當前
norse|諾爾斯語
north|北
not a|不是
notch|刻度
notes|記事
nudge|輕推
nyasa|尼亞沙
nyoro|尼奧羅語
nzima|尼兹馬語
occur|發生
octal|八進位
octet|八位元組
offer|提供
often|常常
ogham|歐甘文
older|舊的
olive|深黃
opera|歌劇
or so|之類
order|排序
oriya|歐利亞語
oromo|奧洛莫語
osage|奧塞奇語
oscan|奧斯坎語
other|其他
outer|外
owned|所擁有
owner|擁有者
paged|置換頁
pager|換頁器
paint|繪製
palau|帛琉
panel|面板
panic|驚恐
paper|紙張
paren|同位
parse|剖析
parts|零件
party|同樂會
paste|貼上
patch|修補程式
pause|暫停
peach|桃色
petal|花瓣
phase|階段
phone|電話
photo|相片
pilot|飛行員
pitch|間距
pixel|像素
place|置放
plain|普通
plane|平面的
plate|盤子
point|點
polka|波爾卡舞蹈配樂
popup|彈出
pound|鎊
power|乘冪
press|按下
price|價格
prime|質數
print|列印
prior|事前
probe|探查
proof|證明
prove|證明
proxy|代理伺服器
pulse|撥盤式電話
punch|打孔
purge|清除
qatar|卡達
quark|夸克
query|查詢
queue|佇列
quick|快速
quiet|安靜的
quite|相當
quota|配額
quote|引言
radii|半徑
radio|無線電
radix|基數
raise|引發
range|範圍
rapid|迅捷的
rated|分級
ratio|比率
razor|剪接
reach|達到
ready|就緒
realm|範圍
refer|參考
relay|中繼
remap|重新映射
renew|續訂
reply|回覆
reset|重置
retag|重新標籤
retro|懷舊
retry|重試
reuse|重新使用
ridge|背脊
right|權力
riyal|里亞爾
robot|機器人
roman|羅馬體
roses|玫瑰
rough|粗糙
round|四捨五入
route|路線
ruble|盧布
ruled|刻度
ruler|尺規
rundi|克倫地語
runic|古代北歐文字
rupee|盧比
rusyn|盧森尼亞語
saami|薩米語
sadly|可惜
salsa|騷莎舞蹈配樂
samba|森巴
samoa|薩摩亞
sango|桑戈語(中非)
sasak|莎莎克語
saudi|沙烏地
scale|尺度
scant|缺乏
scene|場景
scope|範圍
score|分數
scots|蘇格蘭
scout|童子軍
scrap|碎片
screw|螺絲
seoul|首爾
sepia|焦茶色
serer|塞雷爾語
serif|襯線
serve|服務
setup|設定
seven|七
shade|收攏
shake|搖動
shall|應該
shape|形狀
share|共享
shear|修剪
sheet|紙張
shelf|窗架
shell|命令殼
shift|Shift
shiny|光澤的
shock|驚嚇
shona|紹納語
shoot|射擊
short|短
shown|顯示
shred|銷毀
shrub|矮樹
shrug|沒輒
since|自從
sixth|第六
sizes|大小
skill|技能
skirt|下擺
slant|傾斜
slash|斜線
slate|石板
slave|從屬
sleep|暫停
slice|切片
slide|投影片
slope|斜率
small|小
smart|靈巧
smile|微笑
snake|蛇
sniff|嗅探
snoop|窺探
solid|固體
solve|解決
sorry|抱歉
sotho|索托語
sound|聲音
south|南
space|空格
spain|西班牙
spare|備用
spawn|孵出
speak|說出
speed|速度
spell|拼寫
spine|滑骨
split|分割
spoke|輻條
spoof|哄騙
spool|暫存
spoon|湯匙
sport|運動
spray|噴灑
stack|堆疊
staff|員工
stage|階段
stain|玷污
stair|樓梯
stale|失去時效的
stall|停頓
stamp|戳記
start|開始
state|狀態
stats|統計
stdin|標準輸入
steal|竊取
steel|鋼鐵
stick|固定
stiff|生硬
still|仍然
stock|常備
stone|石頭
store|儲存
story|故事
stray|零星的
strip|截除
strut|支撐
stuck|宕機
study|檢查
style|樣式
sucre|蘇克雷
sudan|蘇丹
suite|套裝軟體
super|超級的
swash|鉤耳
swati|史瓦濟語
swift|迅速
swing|Swing 類別
swiss|瑞士
syria|敘利亞
table|表格
taint|髒污
tajik|塔吉克語
taken|佔用
takri|塔卡里文字
tally|計數
tamil|坦米爾語
tango|探戈
taste|品味
tatar|韃靼語
telex|電傳
tenth|第十
terms|條款
tetum|德頓語
thank|謝謝
theft|盜竊
their|它們的
theme|佈景主題
there|那裡
these|這些
thick|粗
thief|小偷
think|覺得
third|第三
those|那些
three|三
throw|丟擲
thumb|拇指
tight|緊密
tigre|泰格瑞語
tilde|波折號
timed|計時
timer|計時器
timne|堤姆奈語
timor|帝汶
title|標題
to-do|待辦
today|本日
token|字組
toner|碳粉
tonga|東加
topic|主題
torus|圓環面
total|總計
touch|着力
tower|塔
trace|追蹤
track|軌段
trail|蹤跡
train|訓練
trash|回收筒
treat|對待
trend|趨勢
trial|試驗
trick|手法
trunk|主幹
trust|信賴
tuner|調諧器
tuple|串組
tweak|調校
tween|補間動畫
twice|兩次
twist|整改
uigur|回紇語
umber|朽葉色
umbra|暗影
unary|一元
uncle|伯叔
uncut|復原剪下
under|之下
union|聯合
unite|統一
unity|合意
unmet|不相配的
unpin|鬆開
unset|解除設定
untag|取消標籤
untar|解包
until|直到
unzip|解壓縮
up to|最高到
upper|大寫
upset|扳倒
usage|使用率
utils|工具
uzbek|烏兹別克語
valid|有效
value|值
valve|活塞
vault|保險箱
vdisk|虛擬磁碟
venda|溫達語
venue|地點
video|視訊
videos|影片
virus|病毒
visit|造訪
vocal|人聲
voice|語音
votic|沃提克語
vowel|母音
voxel|體素
wafer|晶圓
waray|瓦瑞語
washo|瓦紹語
watch|關注
water|水
wedge|楔形
well,|好吧，
welsh|威爾斯語
wheat|小麥色
wheel|輪子
where|位置
which|該項
while|當
whirl|漩渦
white|白色
whois|名錄
whole|整個
whose|其
widow|成寡
width|寬度
wired|有線
wolof|渥魯夫語
woman|婦女
women|婦女
won't|一般不會
world|世界
worth|價值
would|會
write|寫入
wrong|錯誤的
x-ray|侖琴射線
xhosa|科薩語
yacht|快艇
yakut|雅庫特語
yemen|葉門
you'd|您將
zaire|薩伊
zanda|贊德語
zloty|羅提
"added|已加入
"china|中國
"first|第一個
"free"|未用
"least|最低
"make"|建置
"pages|頁數
"place|地點
"right|右側
"space|空間
"today|今天
"tweak|擰轉
"wrote|已寫入
,- and|以及
-en in|於
-en on|於
-en to|到
-error|時發生錯誤
/ help|/求助
16-bit|16 位元
32-bit|32 位元
3d box|立方體
64-bit|64 位元
a load|負載
accent|音調
accept|接受
access|存取
across|跨越
act as|扮演
act on|進行動作
action|動作
active|現用
actual|實際的
ad-hoc|點對點
add as|加入為
add to|加入
add-in|增益功能
add-on|附加元件
addend|加數
addict|上癮者
adding|加入
adhere|遵從
adjust|調整
advice|建言
advise|勸導
adyghe|阿迪何語
aegean|愛琴海
affect|影響
agenda|議程
albeit|縱然
almost|幾乎
always|一律
amount|數目
analog|類比
anchor|錨點
and no|以及沒有
angika|昂加語
angola|安哥拉
animal|動物
annual|全年
answer|應答
anyone|任何人
anyway|無論如何
appear|出現
append|附加
applet|小程式
arabic|阿拉伯語
arawak|阿拉瓦克語
arcade|遊樂場
arctic|北極
armore|受保護
around|周圍
arrive|到達
artist|演出者
ascend|登上
ascent|上升
ask us|詢問我們
aspect|比例
assami|印度方言
assert|主張
assign|指派
assist|輔助
assume|假定
atomic|不可分割的
atsina|阿齊納語
attach|附接
attack|攻擊
attain|達到
augend|被加數
august|八月
author|作者
avaric|阿瓦爾語
avatar|頭像
awadhi|阿瓦德語
aymara|亞摩拉語
b-isdn|寬頻整體服務數位網路
b-isup|寬頻整體服務數位網路使用者部
backup|備份
bahasa|印尼語
balboa|波亞
ballad|流行抒情歌曲
baltic|波羅的語
banana|香蕉
bangla|孟加拉語
bank 0|記憶體庫 0
bank 1|記憶體庫 1
bank 2|記憶體庫 2
bank 3|記憶體庫 3
banned|封禁
banner|橫幅
barred|遮斷
barrel|大桶
basket|購物籃
basque|巴斯克語
be set|被設定
be too|太
bearer|載送
become|成為
before|之前
behave|表現
behind|後方
belize|貝里斯
berber|柏柏爾語
beside|在旁邊
better|更好
beware|注意
beyond|位於之後
bezier|曲線
bhutan|不丹
bigger|較大
bihari|比哈語
billed|買單
binary|二進位
binder|繫結程式
bisque|淡黃
bitmap|位元圖
bleach|漂白
blobby|珠斑
blocky|塊狀圖案
blurry|模糊的
bokmal|巴克摩
bonobo|巴諾布猿
booked|預訂
border|邊框
bother|煩勞
bottom|底部
bought|買了
bounce|彈跳
bounds|邊界
bouvet|布威
box in|盒狀收縮
boxing|封箱
braces|大括號
brahmi|婆羅米文
branch|分支
brasil|巴西
brazil|巴西
breach|違背
breaks|換列和分頁
breton|布里敦語
bridge|橋接器
bright|明亮
broken|不完整的
broker|媒介程式
bronze|銅
browse|瀏覽
brunei|汶萊
bubble|泡泡
bucket|儲存區
budget|預算
buffer|緩衝區
buffet|百匯
bugfix|錯誤修正
bullet|分項符號
bumper|緩衝塊
bundle|叢
buriat|布里亞特語
burner|燒錄器
busted|檢測到
button|按鈕
buzzer|蜂鳴器
byline|署名
bypass|略過
caches|快取
called|被呼叫
callee|被呼叫端
caller|呼叫者
camera|照相機
canada|加拿大
canary|金絲雀色
cancel|取消
canvas|畫布
career|職業
carian|卡里亞文
carmne|大紅
carrot|紅蘿蔔色
casual|隨便的
catena|連鎖
caught|擷取到
causal|因果
causes|原因
cayman|開曼
cd-rom|唯讀光碟機
cd/dvd|光碟
celtic|塞爾特語
center|中心
centre|中心
chakma|查克馬文
chamic|占語
chance|機會
change|變更
charge|費用
cheese|乳酪
cheque|支票
choice|選擇
choose|選擇
choppy|起伏
chorus|合唱
chosen|所選
chroma|顏色類型
chrome|鉻黃
church|教會
cipher|密碼
circle|圓
clause|子句
client|客戶端
co-lay|相容佈局
coarse|粗略
coerce|強制變更
colons|冒號
colour|顏色
column|欄
combat|對抗
comedy|喜劇
commit|定稿
common|共同
comoro|葛摩
comply|遵守
condom|保險套
config|組配
convex|凸面
convey|載送
copies|份數
coptic|科普特文
corner|角
cosine|餘弦
couple|接合
coupon|折價券
course|過程
crease|折痕
create|建立
credit|貸方
creole|克里奧爾語
crisis|危機
crypto|加密
cursor|游標
custom|自訂
cutoff|自動開關
cutter|切割刀
cyprus|賽普勒斯
daemon|守護程式
dakota|達科他語
dalasi|達拉西
damage|損害
damper|阻尼器
danish|丹麥語
dargwa|達爾格瓦語
darken|變暗
darker|較暗
dashed|虛線
dashes|虛線
decent|合宜的
decide|決定
decode|解碼
deduce|推論
deduct|推導
defect|缺陷
defend|辯護
define|定義
deform|形變
defrag|清理磁碟
degree|度
delete|刪除
demand|請求
demote|降級
denote|標誌
depend|依存
deploy|部署
derive|衍生
design|設計
desire|意願
detach|卸離
detail|細節
detect|偵測
detour|繞道
device|裝置
dialog|對話框
dialup|撥號
differ|不同
digest|摘要
digits|數字
dimmed|暗灰色的
direct|直接的
dirham|迪拉姆
dither|遞色
divehi|迪維西語
divide|除
do not|不
docket|摘錄
doesnt|並不
dogrib|多格里布語
dollar|幣
domain|領域
donate|樂捐
dongle|裝置棒
dosage|劑量
dotted|點線
double|雙倍
doubly|雙重
drawer|抽屜
drive"|機
driven|驅動
driver|驅動程式
due in|期限時間
due to|由於
duplex|雙工
during|在的期間
dyadic|雙重的
earbud|耳筒
easier|較容易
easily|容易地
editor|編輯器
eekday|非假日
effect|效果
effort|努力
eighth|第八
either|若非
ekajuk|埃克丘克語
emblem|象徵
emboss|浮雕
enable|啟用
encode|編碼
endian|尾序
ending|結束部分
energy|能量
engine|引擎
enjoy!|祝您使用愉快！
enough|足夠
ensure|確保
entail|招致
entire|整個
entity|實體
epilog|終解
equate|等同
eraser|橡皮擦
erotic|色情
errata|勘誤表
escape|逸出
escudo|埃斯庫多
etched|蝕刻
ethnic|民族音樂
europe|歐洲
ewondo|埃翁多語
exceed|超出
except|除了
excess|過剩
exempt|豁免
expand|伸展
expect|預期
expert|專家
expire|過期
expiry|逾期
export|匯出
expose|展露
extend|延伸
extent|延伸
fabric|機轉
factor|因子
fairly|相當
family|家族
famous|著名的
faster|更快
father|爸爸
faucet|水龍頭
feeder|饋送器
figure|圖
fijian|斐濟語
filing|歸檔
filled|已填
filler|填充位元
filter|篩選器
finder|尋找器
finest|最細緻
finger|手指
finish|完成
finite|有限
first,|首先，
fit to|吻合
fixed"|已修正
flared|喇叭狀
flavor|風格
floppy|軟碟
flower|花
fluent|流利
folder|資料夾
follow|跟隨
foobar|無名
footer|頁尾
for no|表示不要
forbid|禁止
forced|強制的
forget|忘記
forgot|忘記
forint|福林
formal|形式的
format|格式
formed|形成
former|前項
fourcc|四字元碼
fourth|第四
france|法國
freeze|凍結
french|法屬
friday|週五
friend|朋友
fringe|邊緣
frozen|凍結
fulfil|實行
fusion|融合
future|未來
gadget|應用區塊
gaelic|蓋爾語
gagauz|加告兹
gambia|甘比亞
gantry|構臺
garden|花園
gather|積聚
gating|閘控
gender|性別
genome|基因體
german|德語
getter|取值子
global|全域
gluten|麩質
gnomon|折磬形
golden|黃金
gospel|福音音樂
gothic|哥德體
gourde|古德
gravel|碎石
greece|希臘
groove|溝槽
growth|增長
grunge|嘈雜音樂
guides|輔助線
guinea|幾內亞
guitar|吉他
gutter|欄間隔
guyana|蓋亞那
hacker|黑客
halted|已終止
handle|控柄
hangul|諺文
hangup|掛斷
happen|發生
haptic|觸覺的
hassle|困擾
hatran|哈特拉字母
header|頁首
health|運作狀態
heated|加熱的
heater|加熱器
heaven|天堂
hebrew|希伯來語
height|高度
hello?|有人嗎？
helper|輔助程式
hereby|在此
herein|於此
hereof|關於這點
herero|赫雷羅語
hi-end|高級
hidden|隱藏
hobart|荷巴特
holder|托盤
hollow|空心
hoofer|舞者
hooker|胡克
hopper|跳躍式裝置
horror|恐怖
hosted|寄存的
hotkey|快速鍵
how to|如何
humour|幽默
hybrid|並用
hyphen|連字號
ibibio|伊比比歐
if any|即使有
ignore|忽略
impair|受損
import|匯入
impose|施加
in %s.|在 %s 中。
income|收入
indent|縮排
indian|印度語言
indigo|靛藍
infill|內充
inform|通報
ingush|印古什語
inject|注入
inking|加油墨
inline|內聯
insane|狂暴
insert|插入
inside|內部
insult|嘲弄
insure|確保
intact|完整
intent|含義
invert|反向
invite|邀請
invoke|調用
island|島
israel|以色列
issuer|發證者
issues|問題
italic|斜體
itself|它自己
jammed|卡住
jersey|澤西島
jiggle|微動
jitter|抖動
jordan|約旦
julian|儒略曆
jumper|跳接器
jungle|叢林音樂
kabyle|卡拜爾語
kachin|克欽語
kaithi|凱提體
kalmyk|卡爾梅克語
kanbun|漢文
kanqxi|康熙
kanuri|卡努里語
kazakh|哈薩克語
kelvin|凱氏
kenyan|肯亞
kernel|內核
key in|鍵入
keypad|數字鍵臺
keyset|索引鍵集
khojki|和卓文
kikuyu|基庫尤語
killed|砍除
killer|殺手
kituba|吉土巴語
korean|韓語
koruna|克朗
kpelle|克佩勒語
kurukh|庫盧克語
kuwait|科威特
kwacha|瓦查
kwanza|寬扎
kyrgyz|吉爾吉斯
labour|勞力
ladino|拉迪諾語
lahnda|拉亨達語
larger|較大
latest|最近的
latin"|拉丁語
latter|後者
latvia|拉脫維亞
launch|啟動
layout|版面佈局
leader|召集人
leadin|導入
leaves|樹葉
ledger|分類賬
legacy|舊的
legend|圖例
length|長度
lepcha|雷布查文
lesson|課
letter|字母
libyan|利比亞
lignin|木質素
likely|似乎
limits|限度
linear|線性
linger|逗留
linker|鏈結器
linter|梳理器
liquid|液體
listen|聆聽
lister|排列器
little|小型
loaded|已載入
loader|載入器
locale|語區
locals|區域變數
locate|尋找位置
locked|鎖定的
log as|記錄為
log in|登入
log on|登入
logger|自動記錄器
logoff|註銷
logout|登出
lojban|邏輯語
lookup|查找
loosen|鬆開
lot of|許多
lowend|低階
lowest|最低
lushai|盧薩語
luwian|盧維語
lycian|呂基亞文
lydian|里底亞文
macron|長音符
magahi|馬加赫語
magyar|馬劄兒語
mailer|郵件程式
mailto|郵寄到
make a|做出
malawi|馬拉威
manage|管理
manchu|滿洲語
mandar|曼達語
maniac|瘋子
manner|方式
manual|手動
mapper|對映表
marble|彈珠
margin|邊界
marker|標記
markka|芬蘭馬克
markup|標記
maroon|暗紅
mascot|吉祥物
master|主
matrix|矩陣
matter|事情
mbochi|蒙玻奇語
medial|普通的
median|中值
medium|中
member|成員
memory|記憶體
merely|僅僅
meteor|流星
method|方法
metric|度量資訊
mexico|墨西哥
miasma|瘴氣
mic-in|嘜入
micmac|米克馬克語
middle|中間
midway|中途
mining|挖礦
minute|分
mirror|鏡像
missed|錯過的
misuse|濫用
mobile|行動裝置
mockup|樣品
modern|現代型
modify|修改
modula|模塊
module|模組
mohawk|莫霍克語
moksha|莫克沙語
monaco|摩納哥
monday|週一
monkey|猴子
months|月分
mosaic|鑲嵌
mostly|大多
mother|媽媽
motion|移動
movies|影片
munged|偽裝的
mutual|交互
myself|我自己
mystic|神祕
nagari|城文
naming|命名
narrow|窄
native|原生
nature|本質
navaho|納瓦霍語
navajo|納瓦霍語
ndonga|恩敦加語
needed|所需的
negate|打消
nepali|尼泊爾語
newari|尼瓦爾語
newest|最新
nibble|半位元組
niuean|紐埃語
nobody|沒有任何人
noname|無名
nonces|臨時值
nordic|北歐語言
normal|一般
norway|挪威
not an|不是
not so|不要那麼
notary|公證
notice|通知
notify|通知
notion|觀念
nozzle|噴頭
number|數字
nyanja|尼揚賈語
nüshu|女書文字
object|物件
oblige|逼迫
obtain|得到
obtuse|鈍角
office|辦公室
offset|偏移
ojibwa|奧杰布瓦語
oldies|老歌
on job|現場
on the|在之上
on/off|開/關
onbeat|節拍時
one of|之一
online|線上
opaque|混濁
option|選項
orange|橙色
orchid|蘭花紫
orders|訂單
origin|原點
orkhon|鄂爾渾文
orphan|成孤
others|其他人
out of|超出
outage|停機
outbox|寄件匣
output|輸出
outset|外貼
p-code|假擬碼
packet|封包
pageup|上頁
paging|分頁
pahari|帕哈爾
paired|成對
panama|巴拿馬
parent|上層
parity|同位
parser|剖析器
parted|退出了
pashto|普什圖語
passed|傳遞
passes|次數
patent|專利
patron|惠顧者
payoff|代價
pencil|鉛筆
people|人物
period|周期
permit|允許
person|員
peseta|陪士特
petite|小型的
phrase|片語
phuket|普吉島
picker|點取器
pinned|固定的
pinout|腳位
pinyin|拼音
pixmap|像素圖
places|地方
planar|平面的
planck|蒲朗克常數
plasma|電漿
platen|滾筒
player|播放器
please|請
pledge|允諾
plenty|相當
plugin|外掛程式
plural|眾數形
po box|郵政信箱
pocker|卡片格
poland|波蘭
police|警察
policy|策略
polish|波蘭語
pop up|快顯
ported|移植
postal|郵局
powder|粉末
pragma|編譯指示
pranks|鬧劇
preamp|前置放大
prefer|偏好
prefix|前綴
pregap|前置間隙
preset|預先設定
pretty|相當
primus|主教合唱團風格
probed|經測試的
profit|利潤
prolog|前文
prompt|迅速的
proper|適當
public|公開
purple|紫色
pushto|普什圖語
puzzle|解題
quanta|量子
quecha|克丘亞語
quench|淬熄
queued|已佇列
radial|徑向
radius|半徑
random|隨機
ranger|遊騎兵
rapper|饒舌歌手
raster|柵格
rating|分級
rcdata|可替換的字元資料
re-run|重新運行
reader|讀取裝置
readme|讀我檔案
really|真的要
reason|理由
rebase|重定基底
reboot|重新開機
recall|回收
recent|最近使用
record|記錄
redeem|兌換
redial|重新撥號
redraw|重繪
reduce|縮小
refine|重整
refuse|拒絕
regain|恢復
regard|關於
reggae|雷鬼
region|區域
rejang|勒姜文
reject|拒絕
rejoin|重新聯結
relief|浮出的
reload|重新載入
remain|剩下
remark|備註
remedy|補救
remind|提醒
remote|遠端
remove|移除
rename|重新命名
render|潤算
reopen|重新開啟
repack|重新包裝
repair|修復
repeat|重複
replay|重播
report|報告
repost|重新張貼
reread|重新讀取
rescan|重新掃描
rescue|救援
resell|轉賣
resend|重新發送
resign|辭去
resize|調整大小
resnap|重新建立快照
result|結果
resume|再續
resync|重新同步化
retain|保留
return|回傳
retype|重打
reveal|顯現出
revert|回復
review|校閱
revoke|撤銷
reward|報酬
rewind|倒轉
rework|重工
rewrap|自動換列
ribbon|色帶
rights|權
robust|牢靠的
roller|滾輪
romany|羅曼尼語
roster|名冊
rotate|旋轉
rouble|盧布
router|路由器
rowset|資料列集
ruffle|波紋
rugged|崎嶇
ruling|刻度
rupiah|盧比
russia|俄羅斯
rwanda|盧安達
safety|安全
sahara|撒哈拉
salmon|橙紅色
samoan|薩摩亞語
sample|範例
sangro|桑格魯語
sanity|健全
sarati|沙拉提文
satire|諷刺
scalar|純量
scenic|場景
schema|結構描述
scheme|方案
school|學校機構
scorer|刻痕器
screen|螢幕
script|指令稿
scroll|捲動
sealed|密封
search|搜尋
secant|正割函數
second|秒
secret|隱密
sector|磁區
secure|安全化
select|選取
selkup|瑟爾卡普語
seller|銷售者
sender|發送者
sensor|感應器
sepedi|北方索托語
septet|七位元組
sequel|續集
serbia|塞爾維亞
serial|序列
series|系列
server|伺服器
set as|設為
set of|集合
set to|設定為
set up|設置
set-of|集合組
setter|賦值子
settle|結賬
severe|嚴重的
shader|着色
shadow|陰影
shield|盾
should|應該
shrank|縮小了
shrink|收縮
shrunk|縮減了
sidamo|希達摩語
sienna|深黃褐
sights|觀光
signal|信號
signed|帶正負號
signer|簽署人
sikkim|錫金
silent|寂靜的
silver|銀
simple|簡單的
simply|僅需
sindhi|信德語
single|單一
sister|姊妹
sleeve|封套
slider|滑動軸
slovak|斯洛伐克
slower|較慢
smiley|表情符號
smooth|平滑
smudge|塗抹
snooze|延期
so far|目前為止
social|社交
socket|承接座
soften|柔化
solely|僅限
solver|求解器
somali|索馬利亞
sonata|奏鳴曲
sooner|提早
sosofo|序列流動物件規格
source|來源
spacer|空格符號
sparse|稀疏
speech|語音
sphere|球體
spiral|螺旋
spirit|酒精
spline|雲形曲線
spouse|配偶
spread|分佈
sprint|衝刺
spying|間諜
square|方形
squash|壓扁
squish|擠壓
stable|穩定
stanza|詩段
stated|聲明
static|靜態
status|狀態
stderr|標準勘誤
stdout|標準輸出
steady|穩定
stereo|立體聲
sticky|黏着
stitch|縫合
stock"|存貨
stolen|丟失的
strain|勞損
stream|串流
street|街道
stress|應力
strict|嚴格
strike|筆畫
string|字串
stripe|磁條
stroke|筆畫
strong|強固
struct|結構
studio|工作室
stupid|愚蠢
styler|造型師
subdir|子目錄
subkey|子項
submit|提交
subnet|子網路
subrow|次列
subset|子集
sucker|爛人
suffix|字尾
sukuma|蘇庫馬語
summer|加法器
sunday|週日
sunset|日落
supply|供應
surfix|後綴
survey|探究
swatch|樣本
sweden|瑞典
switch|切換
sydney|雪梨
symbol|符號
syntax|語法
syriac|敘利亞語
system|系統
tablet|標牌
tai le|德宏傣文
taiwan|臺灣
tangut|西夏文
target|目標
techno|數位合成音樂
telugu|特拉古語
tereno|特崙諾語
terror|驚悚
tester|測試者
testor|測試器
thaana|塔安那語
thanks|感謝
themes|主題
things|事物
thorax|胸腔
though|雖然
thread|執行緒
threat|威脅
thrice|三次
thumbs|縮圖
thwomp|煤磚
ticker|滾動文字
timing|時機
tissue|組織
to all|給所有
to get|以獲得
to set|以設定
to use|以使用
tobago|托巴哥
toggle|切換
toilet|廁所
tomato|蕃茄紅
tongan|東加語
toward|接近
tracer|追蹤器
trance|催眠
travel|旅遊
treble|三倍
tribal|部落音樂
tricky|巧妙
triple|三倍
trough|槽
truely|真正
try to|試著
tryout|試作
tsonga|宋加語
tswana|茨瓦納語
tugrik|圖格里克
tunnel|隧道
turkey|土耳其
tuvalu|吐瓦魯語
tweets|推文
type 1|Type 1
typing|鍵入
udmurt|烏德穆爾特語
uganda|烏干達
uighur|回紇語
unable|無法
unbind|解除繫結
undock|解除停駐
undone|已復原
unflow|取消流動
unfold|展開
unhide|解除隱藏
unique|惟一
unless|除非
unlink|取消鏈結
unload|卸載
unlock|解除鎖定
unmark|取消標記
unmask|取消遮罩
unmute|取消靜音
unpack|解裝
unplug|拔出
unread|未讀
unscan|未掃描
unsent|未發送
unshow|取消顯示
unsure|不確定
unused|未使用的
unwind|旋開
unwise|不明智
update|更新
updown|上下按鈕
upload|上傳
uptime|工作時間
upward|向上
urgent|緊急
usable|可用
usage:|用法：
use as|做為
use to|用來
useful|有用
uyghur|維吾爾語
vacuum|真空
vanish|消失
varied|各種不同的
vastly|大幅
vector|向量
vendor|供應商
verify|核實
versus|對上
vertex|下角
viable|可行的
victim|受災者
viewer|檢視器
violet|藍紫色
visual|視覺的
voided|作廢
volume|卷冊
vortex|漩渦
vulgar|粗俗
waiver|免除
wakeup|喚醒
walamo|瓦賴語
wallet|錢包
wallon|華隆語
walrus|海象
wander|漂移
warmer|比較溫暖
weaker|較差
webcam|網路攝影機
weekly|每週
weight|權
whilst|正當
widget|視窗元件
widows|段落遺留字串控制
wiggle|擺動
window|視窗
wisdom|智慧
within|在之內
wizard|精靈
wobbly|擺動
woleai|沃雷艾文
worthy|值得
x-axis|X 軸
x-line|小寫字母高線
y-axis|Y 軸
yapese|雅蒲語
yellow|黃色
yoruba|約魯巴語
you'll|您將
z-axis|Z 軸
zambia|尚比亞
zenaga|澤納加語
zhuang|壯語
zhuyin|注音
zombie|殭屍
"do not|不要
"places|位置
"script|手寫體
"second|第二
%d hour|%d 小時
%s hour|%s 小時
, as if|就如同
-be -en|被
-be not|不是
105-key|105 鍵
18-hole|18 洞
24 hour|24 小時
a board|機板
a colon|冒號
a light|輕量
a place|一個地方
a4 plus|A4 加大
abandon|放棄
abdomen|腹部
ability|性能
abusive|謾罵
academy|學院
account|賬號
achieve|達成
acquire|獲取
acronym|縮寫
actives|動態
actuate|作動
ad spot|廣告片段
adangme|阿當梅語
adapter|配接卡
adaptor|配接卡
add new|加入新的
add-ins|增益集
address|位址
advance|事先的
afghani|阿富汗尼
african|非
against|針對
agility|敏捷性
albania|阿爾巴尼亞
alerter|警示器
algebra|代數
algeria|阿爾及利亞
aligner|直線對準器
all day|整天
all its|它所有的
allergy|過敏
already|已經
ambient|環境音樂
amharic|阿姆哈拉語
an hour|一小時
anagram|迴文
analyze|分析
ancient|古老的
andorra|安道爾
animate|動畫
annuity|年金
another|另一個
anycast|任播
anymore|再繼續
appease|安撫
approve|認可
aramaic|阿拉姆語
arapaho|阿拉帕霍語
archaea|古菌
archive|封存
arcsine|反正弦
arising|引起
armenia|亞美尼亞
arrange|排列
article|文章
artwork|原圖
as read|為已讀
as root|以 root 身分
as well|同樣
ask for|要求
assault|襲擊
assured|確保
at most|最多
at once|一下
attempt|試圖
audible|聽覺的
austria|奧地利
avatime|阿瓦蒂梅語
average|平均值
avestan|阿維斯塔語
awesome|太棒了
back to|回到
backend|後端
backtab|向後的跳格鍵
bahamas|巴哈馬
bahrain|巴林
balance|平衡
balloon|汽球
baluchi|俾路支語
bambara|班巴拉語
banking|銀行業務
barcode|條碼
barrier|障礙
bashkir|巴什喀爾語
bass up|加強低音
battery|電池
be also|也是
be busy|忙碌中
be down|已停機
be full|已滿
be gone|已經不見
be just|就
be kept|被保持
be rare|很罕見
"be sure|請確認
be sure|確認
bearing|留白
because|因為
belarus|白羅斯
belgian|比利時語
belgium|比利時
beneath|之下
benefit|好處
bengali|孟加拉語
bermuda|百慕達群島
besides|此外
betters|長輩
between|介於
bhutani|不丹語
bicubic|雙立體
bidding|競標
billing|賬目
biofilm|生物膜
bipolar|雙極
bislama|比斯拉馬語
bitmask|位元遮罩
bitrate|碼率
bitwise|逐位元
blended|混色
blocked|阻斷
bolivia|玻利維亞
bonaire|波內赫
boolean|布林
bosnian|波士尼亞語
bounded|界定
bow tie|蝴蝶領結
boycott|抵制
bracket|中括號
braille|盲人點字符號
breaker|破壞者
bridged|橋接化
britain|英國
british|不列顛
britpop|英式另類搖滾
brittle|易碎
broadly|廣泛地
brother|兄弟
brought|帶來
brouter|橋接路由器
browser|瀏覽器
builder|產生器
builtin|內建
bundled|附帶的
burmese|緬甸語
burster|分離器
burundi|蒲隆地
but not|並不是
by date|依日期
by flag|依旗標
by hand|手動
by mail|依郵件
by name|依名稱
by size|依大小
by type|依類型
cabaret|卡巴萊歌舞
cabinet|機櫃
cabling|佈纜
calling|呼叫
can not|無法
cap-set|能力集
capital|首都
capname|大寫名稱
capsule|膠囊
captcha|人機驗證
caption|題要
capture|擷取
carrier|載波
cartoon|動畫
cascade|重疊顯示
casette|卡式錄音帶
casters|腳輪
casting|轉型
catalan|加泰羅尼亞語
catalog|型錄
catchup|設回未讀
caution|留意
caveats|注意事項
cd case|光碟盒
cd copy|拷貝光碟
cd-copy|光碟副本
cd-text|光碟文字
cebuano|宿霧語
cedilla|尾形符號
ceiling|頂符號
celsius|攝氏
central|中央
certain|某些
certify|授證
channel|頻道
chanson|法國香頌
chapter|章
charset|字元集
chassis|機架
chechen|車臣語
checked|已勾選
checker|檢查器
chemist|化學家
chequer|審核員
chibcha|奇布查語
chiffon|雪紡
chinese|漢語
chipset|晶片組
choctaw|喬克托語
choosen|選擇
chooser|選擇器
chuvash|楚瓦什語
circuit|電路
clarify|釐清
classic|傳統型
cleanup|清理
climate|氣候
clipart|美術圖形
closely|接近
closeup|特寫
closure|閉合
cluster|叢集
coating|塗層
codeset|碼集
coexist|共同存在
cohorts|同夥
collate|排序
collect|收集
colored|着色的
colours|色
columns|欄位
combine|合併
command|命令
comment|評論
compact|壓縮
company|公司
compare|比較
compile|編譯
complex|複雜
compose|撰寫
compute|計算
concave|凹面
concept|概念
concert|音樂會
conduct|控管
conduit|通道
confirm|確認
confuse|困惑
conical|圓錐
connect|連接
consent|允諾
consist|組成
console|主控臺
consult|顧問
consume|消耗
contact|聯絡人
contain|內含
content|內容
contest|爭奪
context|語境
contour|輪廓
control|控制
convert|轉換
cookies|訊餅
coprime|互質
corners|轉角
cornish|康沃爾語
coronal|冠切面
correct|修正
corrupt|損壞
counter|計數器
country|國家
courier|轉送者
covered|談到過
cracker|駭客
crackle|爆音
creator|建立者
credits|銘謝
crimean|克里米亞
crimson|大紅
croatia|克羅埃西亞
crossed|十字形的
crucial|至關重要
cruzado|克魯薩多
cryptic|加密的
cur pos|游標位置
current|目前的
cursive|草寫的
cutting|切割
cypriot|賽普勒斯
dahomey|達荷美
damping|潤版
darkred|深紅
dataset|資料集
ddepoke|DDE 寫入
decades|數十年
decimal|十進位
declare|宣告
declick|雜音消除
decline|婉拒
decoder|解碼器
decrypt|解密
default|預設
defense|防守
deflate|消氣
defocus|失焦
defunct|失去功能
degauss|消磁
degrees|度數
delimit|定界
deliver|投遞
demotic|通俗的
denmark|丹麥
density|密度
deposit|保證金
dequeue|移出佇列
descent|下降
deseret|德瑟雷特文
desired|設想的
desktop|桌面
despite|儘管
destroy|銷毀
develop|開發
devoice|取消語音
dhivehi|迪培希語
diagram|圖表
dial up|撥號
dialect|方言
diamond|鑽石
dictate|規定
did not|並未
did you|您是否
diffuse|擴散
digital|數位
digraph|雙併詞
dimgray|暗灰
dimming|暗淡
disable|停用
discard|捨棄
discuss|討論
dismiss|去除
display|顯示
dispose|棄置
dispute|爭論
disrupt|岔斷
distort|扭曲
disturb|打擾
diverse|多樣的
divisor|除數
do that|那樣做
do this|這樣做
domains|網域
dormant|休止
downmix|下降混合
drag in|拖入
drawing|繪圖
drop-in|掉入
dropper|滴管
drumkit|爵士鼓
dry run|模擬測試
ductile|柔軟
dynamic|動態
ear-mic|耳嘜
earlier|前者
easiest|最容易的
eastern|東
eclipse|橢圓
ecology|生態學
ecuador|厄瓜多
elamite|埃蘭語
elapsed|過了
elegant|優雅的
element|元件
ellipse|橢圓
embargo|禁運
embrace|擁抱
embrave|鼓舞
emerald|翡翠
emitted|發出
empower|注入活力
emulate|擬真
enabled|已啟用
enclose|封閉
encoder|編碼器
encrypt|加密
end-tag|結束標籤
endless|不中斷
endnote|尾註
endorse|背書
endstop|終點
enforce|強制
england|英格蘭
english|英語
enhance|增進
enlarge|放大
enqueue|進入佇列
enquiry|詢問
entitle|賦名
entropy|熵
envelop|籠罩
episode|事件
epitaxy|磊晶
equador|厄瓜多
erasure|抹除
eritrea|厄利垂亞
escaped|逸出的
estonia|愛沙尼亞
even if|即使
examine|審查
example|範例
excerpt|摘錄
exclude|排除
execute|執行
exhibit|展出
existed|已存在
expense|費用
explain|解釋
exploit|剝削
explore|探查
express|遞送
expunge|刪掉
extract|抽出
extrema|末端
extrude|擠壓
factory|工廠
fade in|淡入
fadeout|淡出
failure|失敗
falloff|衰減
fallout|衰減
fanfold|複寫紙
fantasy|幻想
faroese|法羅群島語
fashion|流行
fastest|最快
favicon|站臺圖示
feather|羽化
feature|特徵
federal|聯邦
fill in|填入
filling|充填
finally|最後
finance|財務
finland|芬蘭
finnish|芬蘭語
fitness|適合
fixture|型架
flatbed|平板
flatten|平面化
flicker|閃爍
focused|聚焦
for now|暫時
for yes|表示同意
for you|為您
foreign|外來
foreman|領班
forever|永遠
formula|公式
forward|前進
founded|成立
foundry|鑄造廠
fourier|傅立葉
fractal|碎形
frankly|坦白地說
free up|釋放掉
freeing|釋放
french"|法語
frisian|夫里斯蘭語
from us|從我們
frustum|平截頭體
fuchsia|桃紅
fulfill|完全達到
functor|仿函式
further|進一步的
gallery|圖片集
gamboge|藤黃
gangsta|幫派
gangway|走道
garbage|無用資料
garbled|錯亂
gateway|閘道器
general|一般
generic|通用
genlock|同步耦合
georgia|喬治亞
germany|德國
gesture|手勢
gimmick|噱頭
give up|放棄
go back|返回
goes by|流逝
gpg key|GPG 金鑰
gradual|逐漸的
grammar|文法
grantha|加蘭塔文
grantor|授與者
granule|精度
graphic|圖形
gravity|重力
graymap|灰階圖
greater|更大
greeter|接待程式
grenada|格瑞那達
gripper|咬紙機
gtk-add|加入
guarani|瓜拉尼語
guilder|盾
hacking|黑作
haitian|海地語
handler|處理常式
handout|講義
hang up|掛斷
hankaku|半角
hanunoo|菲律賓－的含努鬧語
hard to|難以
harmful|有害
harmlet|哈姆雷特
harness|駕馭
harpoon|魚叉
hartley|哈特來
harvest|獲得
hashtag|雜湊標籤
hatched|包覆
have no|沒有任何
have to|必須
heading|標頭
headset|耳嘜
hectare|公頃
held in|存放於
help me|幫幫我
help us|幫助我們
helpful|有幫助
highend|高階
highest|最高
highway|高速通道
hinting|修飾
hip-hop|嘻哈風格
his/her|他的
history|歷史
hittite|西臺語
holding|保有
holiday|假日
hot key|快速鍵
hotlist|常用列表
hotpink|暗粉紅
hotspot|熱點
housing|外罩
houston|休士頓
however|然而
hungary|匈牙利
i-field|資訊欄
iberian|依伯利亞
iceland|冰島
iconify|最小化
iconize|最小化
if not,|如果沒有，
if-then|若則
illegal|不合法的
imaging|成像
imprint|蓋印
improve|改善
impulse|脈衝
in case|若是
in fact|事實上
in loop|循環
in menu|在選單中
in name|在名稱中
in secs|以秒為單位
in time|及時
in tray|於系統匣
in turn|然後
in-band|頻帶內
in-line|列間的
inbound|輸入向的
include|包含
indexer|索引子
indices|索引
inertia|慣性
inexact|不精確的
inflate|膨脹
inherit|繼承
inhibit|抑制
initial|初始
inktake|導入
inquire|查詢
inquiry|查詢
insofar|當
inspect|檢查
inspire|啟發
install|安裝
instant|即時
instead|做為替代
integer|整數
intense|強烈
inupiak|依奴皮維克語
inupiaq|依努庇克語
invalid|無效的
inverse|反
invoice|發票
invoker|調用者
involve|牽連出
ireland|愛爾蘭
islamic|伊斯蘭
islands|群島
isoland|分隔區
isolate|隔離
italian|義大利語
itemize|列舉
iterate|迭代
jaggies|鋸齒狀
jamaica|牙買加
january|一月
johndoe|無名氏
journal|日誌
jukebox|媒體櫃
jump to|跳到
jurchen|女真文
justify|調整
k-space|頻率空間
kannada|卡納達語
karachi|喀拉蚩
kashmir|喀什米爾
keeling|基林
keyhole|鎖眼
keyring|鑰匙圈
keyword|關鍵字
killing|砍除中
kingdom|王國
kirghiz|吉爾吉斯語
kirundi|科隆地語
klingon|克林貢語
konkani|貢根語
kurdish|庫德語
kutenai|庫特內語
kyrgyz"|吉爾吉斯語
lack of|欠缺
landing|降落
lapland|拉普
lappish|拉普語
largest|最大
latency|延時
lattice|晶格
latvian|拉脫維亞語
lawsuit|訴訟
lead to|導致
leading|前導
leadout|導出
leakage|漏
lean on|倚靠
learner|學習者
lebanon|黎巴嫩
leisure|休閒
lemming|旅鼠
leonese|阿斯圖里亞斯語
lesotho|賴索托
lessons|課程
lettish|列特語
lexical|詞彙的
libelus|誹謗
liberia|賴比瑞亞
library|函式庫
licence|授權
license|授權
lighten|照亮
lighter|較明
like it|喜歡它
limiter|限制器
line up|貼齊
line-in|線入
lineart|線圖
lingala|陵加拉語
linkage|鏈結
literal|實字
live cd|自活光碟
locally|局部地
locator|定位器
lock in|套牢
lock-in|限定
lockout|鎖上
log off|登出
log out|登出
logfile|日誌檔案
logical|邏輯的
logname|登入名稱
longest|最長的
look at|查看
look in|查找於
look up|查閱
looping|循環
lots of|非常多的
luiseno|盧伊塞諾語
machine|機器
magenta|洋紅
magnify|放大
mailbox|信箱
mailing|郵寄
makasar|望加錫語
make no|無法做出任何
make up|構成
maltese|馬爾他語
manager|管理器
mandaic|曼底安文
maniacs|狂熱者
mankind|人類
manual"|手冊
mapfile|映射檔案
marathi|馬拉提語
margins|邊距
mariner|海事人員
mark as|標記為
markout|註明
marocco|摩洛哥
marquee|圈選
marwari|馬爾瓦利語
massive|巨大的
mastery|掌控
maximal|最大
maximum|最大
may not|可能無法
mayotte|馬約特
meaning|含意
measure|量測
meeting|會議
mention|提及
menubar|選單列
mercury|水銀
mess up|弄亂
message|訊息
metical|梅蒂卡爾
metrics|字框
mexican|墨西哥
mi'kmaq|米克馬克語
midline|中線
midrule|中段
migrate|遷移
minihub|迷你集線器
minimal|最少
minimum|最小
minuend|被減數
minutes|分鐘
miracle|奇蹟
missile|火箭
mission|任務
mistake|錯誤
mm film|公釐影片
mock-up|樣品
modulus|模數
moldova|摩爾多瓦
monarch|君主
monitor|監視器
montage|混成拼貼
monthly|每月
morocco|摩洛哥
most of|大部分
move up|向上移動
multani|穆爾塔尼文
multloc|多重位置
musical|音樂劇
mutable|可變的
myanmar|緬文
mystery|神祕
namibia|納米比亞
natural|自然
ndebele|恩德貝勒語
nearest|最近的
need to|需要
netbook|小筆電
netload|網路流量
netmask|網路遮罩
netname|網路名稱
netting|編織物
network|網路
neutral|中性
new age|新世紀
new key|新的索引鍵
newline|新列字元
nigeria|奈及利亞
nirvana|涅槃
no free|沒有可用的
no more|已無更多
no room|沒有空間
nominal|標稱
none of|沒有任何
nonzero|非零值
norfolk|諾福克
normals|法線
normaly|通常
not -en|未
not all|並非所有
not now|不是現在
not the|不是
not yet|尚未
nothing|沒有任何東西
notice:|注意：
nowaday|當今
nucleus|核心
numbers|數量
numeral|數字
numeric|數值
nynorsk|耐諾斯克
oblique|傾斜的
obscene|猥褻
observe|觀察
occitan|奧克西坦語
october|十月
offline|離線
oldlace|舊布黃
on hand|在庫
on left|左側
on line|於列上
on-link|鏈上
on-site|現場的
one way|單向
ongoing|進行中的
op-mode|作業模式
opacity|濁度
operand|運算元
opinion|意見
optical|光學
optimal|最佳化
ordered|已排序的
ordinal|序數
orphans|段落前分頁
osmanya|歐斯曼亞文
ossetic|奧塞提語
ottoman|鄂圖曼
outages|停電
outdate|過期
outgrew|增長
outline|描邊
outlook|展望
outside|外側
outward|向外
overall|全面
overdue|過期
overlap|重疊
overlay|外覆
overrun|超出
own the|擁有
pacific|太平洋
package|套件
packing|打包
padding|填補
page %s|第 %s 頁
page in|置入分頁
page up|向上一頁
pahlavi|巴勒維
palauan|帛琉語
palette|調色盤
panning|平移
parabel|拋物線
partial|部分
partner|夥伴
pass on|傳送
pass to|傳遞給
passage|段落集
passing|傳遞
passive|被動
patches|修補檔案
patient|病患
pattern|胚騰
payload|酬載
payment|款項
penalty|懲罰
pending|擱置
percent|百分比
perform|施行
perhaps|也許
persian|波斯語
persist|持續
persona|身分
pervail|盛行
physics|物理學
pick up|接聽
picking|挑選
picture|圖片
pin the|固定
pinhole|針孔
plan to|計畫要
plastic|塑膠
plotter|繪圖器
plug in|插入
plug-in|外掛程式
pointer|指標
pollard|柏格理拼音符
polling|意見調查
polygon|多邊形
popular|常用
porting|移植
portion|部分
postfix|後綴
postgap|後置間隙
posture|姿勢
powered|提供動力
prc 16k|中式十六開
prc 32k|中式卅二開
precede|前繼
precise|確切
predict|預測
preedit|預編輯
preempt|搶佔
preface|起頭
preload|預先載入
premium|付費
prepare|準備
prepend|前置
present|呈現
pressed|已按
presume|推測
prevent|防止
preview|預覽
pricing|制定價格
primary|主項
priming|引墨
printer|印表機
privacy|隱私
private|私人
probing|試探
problem|問題
proceed|繼續
process|處理
produce|產生
product|產品
profile|側寫
program|程式
project|專案
prolong|延長
promise|約定
promote|推廣
prompt"|提示
propose|提議
protect|保護
provide|提供
psalter|聖詩體
publish|發行
pull to|拉下以
pulsate|脈衝
punjabi|旁遮普語
purpose|宗旨
pyramid|棱錐
qr code|快應條碼
qualify|限定
quality|品質
quantum|定量
quarter|四分之一
quechua|印加語
quetzal|格查爾
queuing|排隊
quiesce|靜止
r-value|右值
radians|弧度
radical|根號
rainbow|彩虹
raising|舉起
ranking|分等
rapanui|拉巴怒伊語
readapt|適應
realize|實現
reblend|重新混成
rebuild|重新組建
receipt|接收者
receive|接收
recency|新近度
recheck|重新檢查
reclaim|收回
recover|復原
recruit|招募
recurse|遞迴
referer|參照頁
reflect|反映
refocus|重新聚焦
refresh|重刷
refunds|退款
refusal|拒絕
regular|標準
reindex|重新索引
relabel|重新貼標
related|相關的
release|釋出
rely on|所依靠的
removal|撤除
renewal|重申
renewed|續新的
reorder|重新排序
repaint|重新繪製
replace|置換
replica|複本
replied|已回覆
reprint|復刻
reptile|爬蟲
request|請求
require|需求
reroute|重設路線
rescale|重定比例
reserve|保留
reshape|重設形狀
residue|殘餘
reslice|重新切片
resolve|解析
respond|反應
restart|重新啟動
restore|還原
retired|退隱的
retouch|修補
retrace|重新追蹤
retract|取消
retrive|檢索
reunion|留尼旺島
revenue|收益
reverse|反向
revised|修訂
revival|復興
rewrite|改寫
rhombus|菱形
ripping|轉刻
risk to|冒險
robbing|奪取
robotic|機械的
roll up|向上捲動
rolling|滾動
romania|羅馬尼亞
romansh|里托羅曼語
roughly|大致上
rounded|圓角
rounder|繞行者
routine|常式
royalty|版稅
rub out|擦掉
running|執行
runtime|執行階段
russian|俄語
same as|如同
samples|樣本
sandawe|桑達韋語
santali|桑塔利文
sardine|沙丁魚
satisfy|滿足
sausage|香腸
save as|另存新檔
save to|存入
savings|儲蓄
scaling|縮放比例
scanner|掃描器
science|科學
scooter|摩托車
scoring|刻痕
scratch|暫用
seagull|海鷗
secrecy|祕密性
section|區段
segment|資料段
seminar|研討會
senegal|塞內加爾
serbian|塞爾維亞語
serious|嚴重的
serpent|蛟
service|服務
sesotho|塞索托語
session|作業階段
set-off|反印
setting|設置
settled|已結清
seventh|第七
several|多個
shabang|井歎號
shading|遮蔽
shall i|我應該
shallow|淺薄的
shannon|向農
sharada|夏拉達文
sharpen|銳化
shavian|蕭伯納字母
shebang|井歎號
shelter|避難所
shorten|縮短
shortly|在短時間內
show up|顯現
shuffle|隨機播放
shuswap|蘇士瓦
shuttle|飛梭
sibling|兄弟姊妹
sichuan|四川
siddham|悉曇文
sidebar|側邊欄
sign in|簽入
sign on|簽到
sign up|報名
signage|告示
signing|簽署
siksika|西克西卡語
silence|靜音
silvery|銀色
similar|類似的
simplex|單工
sinhala|錫蘭僧加羅語
sinitic|漢語族
siswati|西斯瓦提語
sitemap|網站地圖
sizable|可調大小的
skip to|跳到
skipped|略過
skyblue|天藍
slewing|旋轉
sliders|調整器
sliding|滑動
slitter|裁刀
slovene|斯洛維尼亞語
slowest|最慢
smaller|較小
snap to|靠齊
snap-in|嵌入式管理單元
snippet|片段
so many|那麼多
sogdian|粟特語
solidus|斜線
solomon|索羅門
somali"|索馬利亞語
somalia|索馬利亞
some of|其中的一些
someone|某人
soninke|索寧克語
sorbian|文德語
sort by|排序依據
spacing|間隔
spammer|垃圾信寄件者
spanish|西屬
spanned|展開
speaker|揚聲器
special|特殊
specify|指定
speckle|斑點
spectre|幽靈
spin up|加速
sponsor|贊助者
spooler|暫存器
springs|彈簧
ssl key|SSL 金鑰
stacked|重疊
stacker|堆疊器
stagger|錯開
staging|整備
standby|待機
startup|啟動
stately|莊嚴的
station|站臺
stencil|紙版
step by|逐步執行單位
step in|逐步跳入
stop-go|停止然後繼續執行
storage|貯藏體
storing|存入
strange|怪異的
streams|資料流
stretch|擴展
student|學生
sub-key|子鍵的
subband|次頻帶
subcode|子碼
subfile|子檔案
subform|子表單
subject|主旨
submenu|子選單
subname|子名稱
subnode|子節點
subpath|子路徑
subsume|包容
subtest|子測試
subtree|子樹
subtype|子類型
succeed|成功
success|成功
such as|像是
suction|真空吸着
suggest|建議
summary|概要
sunrise|日出
support|支援
suppose|假設
surface|表面
surname|姓氏
survive|存活
suspend|懸置
swahili|史瓦西里語
swedish|瑞典語
symlink|符號鏈結
synonym|同義字
systray|系統匣
t-shirt|套衫
tab bar|頁籤控制列
tabloid|小報紙
tagalog|塔加拉語(菲律賓)
tagging|貼標
tagline|經典臺詞
talk to|告訴
tangent|正切
tapping|觸點
tarball|打包檔
taskbar|工作列
teacher|老師
tearoff|撕開線
telefax|傳真
tengwar|精靈－談格瓦文
ternary|三進
terroir|風土條件
textbox|文字方塊
textual|文字
texture|花紋
the new|新的
thereof|由此
thereto|此外還有
thermal|熱
this is|這是
thought|念頭
through|透過
tibetan|藏語
tickets|工單
timeout|逾時
tirhuta|邁蒂利文
tlingit|特林吉特語
to edit|以編輯
to find|以尋找
to free|以釋放
to help|以協助
to hold|以存放
to left|往左
to make|要讓
to mean|以表示
to open|以開啟
to pass|以傳遞
to quit|以離開
to self|給自己
to show|以顯示
to skip|以跳過
to stat|顯示狀態
to tilt|以偏斜
to type|輸入
to view|以檢視
tokelau|托克勞
too far|太遠
too few|太少
toolbar|工具列
toolbox|工具箱
tooling|模具
toolkit|工具組
tooltip|提示框
top ten|前十名
torpedo|魚雷
torrent|訊流
totally|完全
tracker|追蹤者
traffic|流量
trailer|結尾
trashed|已回收
treemap|樹狀
trickle|涓滴
trigger|觸發
trimmed|已修整
trimmer|修剪器
trouble|麻煩
tuesday|週二
tumbuka|通布卡語
tunisia|突尼西亞
turkish|土耳其語
turkmen|土庫曼語
turn on|打開
turners|旋轉器
twelfth|第十二
two-way|雙向
type in|輸入
typeset|排版
typhoon|颱風
ugariti|烏加里特字母
ukraine|烏克蘭
umbundu|姆本杜語
unbound|未繫結
uncheck|取消核取
unclear|不清楚
unclump|拆解
uncoded|未定碼
undoing|毀滅
unearth|挖掘
unequal|不等
unfloat|固定
ungroup|取消分組
unicast|單點傳送
unicode|萬國碼
unidata|單一資料
unified|統一
uniform|單一形式
unknown|不明
unmerge|取消合併
unmount|卸載
unnamed|未命名
unpause|不暫停
unquote|引言結束
unrated|未分級
unsaved|未儲存的
unshade|鋪展
unsplit|復原分割
unstick|脫離
untrace|不追蹤
unusual|不尋常的
upgrade|升級
upright|直立
urgency|急迫性
uruguay|烏拉圭
use for|用於
used to|用來
useless|無用的
usually|常常
utility|公用程式
utilize|利用
v-nonce|非重複數字
vanilla|香草
vanuatu|萬那杜
variant|變體
various|各種
vary by|依而不同
vatican|梵蒂岡
vehicle|車輛
verbose|詳細的
verdict|判決
version|版本
vertigo|眩暈
veteran|資深
vietnam|越南
view as|檢視為
vintage|優質
violate|妨害
virtual|虛擬
visible|可見的
volapuk|沃拉普克語
voltage|電壓
vt-mode|虛擬終端機模式
wake up|喚醒
walloon|瓦隆語(比利時)
want to|要
warrant|保證
watcher|監看員
weather|天氣
webshop|網路商店
website|網站
weekend|週末
welcome|歡迎
western|西
whether|是否
whoever|某人
winlist|視窗列表
wish to|希望
with no|不具任何
without|而不需
wording|措辭
workday|工作日
worship|禮拜
wrapper|包繞程式
written|手寫的
xheight|小寫字母高度
yiddish|意第緒語
you may|您可以
zapotec|薩波特克語
zenkaku|全角
zipfile|壓縮檔
zoom in|放大
"proceed|要繼續嗎
%d items|%d 個項目
%d of %d|%2$d 中的 %1$d
%d times|%d 次
%i of %i|%2$i 中的 %1$i
%i times|%i 次
%s of %s|%2$s 中的 %1$s
%u of %u|%2$u 中的 %1$u
-be -ing|正在
a lot of|很多的
a period|句號
a set of|一組
a3 extra|A3 特大
a4 extra|A4 特大
a5 extra|A5 特大
abnormal|不正常
about to|即將
absolute|絕對
abstract|摘要
ac power|交流電源
accepted|接受的
acceptor|接受者
accessor|存取器
accident|意外
accuracy|準確度
accurate|正確
achinese|亞齊語
acoustic|聲音學
acquirer|收單機構
activate|活化
actively|主動
activity|活動
actually|實際上
actuator|致動器
adaptive|適應型
add mode|加法模式
added to|已加入至
addition|增加
additive|加乘
adjacent|相鄰
adjuster|調整器
advanced|進階
affinity|近似者
afrihili|阿弗里希利語
agree to|同意
airbrush|噴槍
akkadian|阿卡德語
albanian|阿爾巴尼亞語
algerian|阿爾及利亞語
aliasing|鋸齒
all site|全站
alliance|聯盟
allocate|配置
allotted|所分配的
allow us|讓我們
alphabet|字母
although|雖然
altitude|海拔
amethyst|紫水晶
an empty|空的
analyses|分析
analysis|分析
analytic|分析
analyzer|分析器
ancestor|原始節點
and also|並且
and exit|然後退出
and gate|及閘
and must|且須
and soon|不久還有
and then|然後
and will|並將
angstrom|埃
anguilla|安圭拉
annotate|註解
announce|宣佈
any kind|任何種類
any more|再任何
any type|任意型式
anything|任何事
anywhere|任何地方
aperture|光圈
appendix|附錄
approach|作法
approval|認可
approver|批准者
archives|封存檔案
argument|引數
armenian|亞美尼亞語
artifact|影像瑕疵
as below|如下
ascender|上緣部分
assamese|阿薩姆語
assemble|組合
assembly|組譯的
asserted|主張的
asterisk|星號
asturian|阿斯圖里亞斯語
at least|至少
attended|有人值守的
attorney|律師
audio cd|音訊光碟
austrian|奧地利的
authless|非認證式
autofill|自動填入
autohide|自動隱藏
autohint|自動修飾
autoload|自動載入
automail|自動電子郵件
automate|自動化
autosave|自動儲存
autosize|自動調整大小
autotext|自動圖文集
back end|後端
backbone|網路骨幹
backdate|回溯日期
backdrop|背景
backlink|反向鏈結
backtick|反引號
backward|退一步
badblock|壞損區塊
balinese|峇里語
balloons|提示框
banderas|班德拉斯
barbados|巴貝多
base url|基準網址
based on|基於
baseline|基準線
basename|基底名稱
baybayin|貝貝因字母
be about|約為
be awful|很可怕
be empty|是空的
be not a|並非
be still|仍然是
beginner|初學者
behavior|行為
best use|最佳利用
bhojpuri|博杰普里語
big band|大樂隊
bilberry|歐洲藍莓
bilinear|雙線性
birthday|生日
bistable|雙穩態
bit rate|位元速率
bitdepth|位元深度
blanking|留空白
blending|混色
blocking|阻斷
bookmark|書籤
bootable|可開機的
bopomofo|注音
bordeaux|深紅色
botswana|波札那
boundary|邊界
bows out|鞠躬下臺
breakout|爆發
brighten|增亮
bring up|帶出
brochure|小手冊
buginese|布吉語
build up|組裝
build-in|內建
building|建立
built in|內建
built up|建立起
bulgaria|保加利亞
bulletin|佈告
business|商務
by email|依電子郵件
by month|依月分
bytecode|位元組碼
calendar|行事曆
callback|回呼
callouts|圖說文字
cambodia|柬埔寨
camcoder|攝影機
cameroon|喀麥隆
campaign|造勢
can also|也能夠
can even|甚至能夠
can help|能夠幫助
can only|衹能
can type|能夠輸入
cap-mark|能力標記
capacity|容量
capitals|大寫字母
card set|牌組
cardinal|基數
carousel|轉盤
catalyst|加速器
category|分類
catenate|聯結
cd image|CD 映像檔
centered|置中的
chagatai|察合臺語
chamorro|查莫羅語
check if|檢查是否
check in|簽入
check to|勾選以
checkbox|核取方塊
checkout|簽出
checksum|總和檢查碼
cherokee|卻洛奇語
cheyenne|夏延語
chichewa|契切瓦語
children|孩子
chuukese|丘克語
cinnamon|肉桂色
circular|環狀
citation|引用
citizens|民眾
claimant|宣稱者
class id|類別識別項
classify|分類
clean up|清理
cleaning|清理
clearing|清除
clemency|仁厚
click to|按一下以
clinical|臨床的
close-up|特寫
clothing|衣着
clusters|磁簇
cmd-line|命令列
codebook|碼簿
codepage|編碼頁
codeword|碼字
coercion|強制型轉
colinear|共線
collapse|崩壞
collator|對併器
colombia|哥倫比亞
colophon|版本記錄
colormap|顏色對照表
commerce|貿易
commonly|通常
comparer|比對子
compiler|編譯器
complain|抱怨
complete|完成
composer|作曲
compound|複合
compress|壓縮
comprise|包括
computer|電腦
concrete|具象的
condense|緊縮
confined|受限的
conflict|衝突
conjunct|結合
conserve|保存
consider|認為
constant|常數
consumer|消費者
contains|含有
continue|繼續
contract|合約
contrary|矛盾
contrast|對比
controls|控制項
converge|聚集
conveyor|輸送帶
copyback|副本回存
copyleft|著作傳
cornsilk|玉米穗黃
corotron|電暈架
corsican|科西嘉語
coupling|耦合
covalent|共價
covenant|契約
coventry|考文垂
coverage|覆蓋的
cowardly|斗膽
creation|建立
criminal|刑事
criteria|準則
critical|關鍵
croatian|克羅埃西亞語
crossbar|十字橫筆
crossing|跨越
cultural|文化
cupboard|杯墊
currency|貨幣
customer|客戶
cylinder|磁柱
cyrillic|西里爾字母
dangling|懸盪
dark red|深紅
darkblue|深藍
darkcyan|深青綠
darkgray|深灰
darkness|暗度
darkroom|暗房
darkwave|黑潮音樂
data set|資料集
database|資料庫
datagram|資料包
datatype|資料型態
datetime|日期時間
dde poke|DDE 寫入
dead key|無作用鍵
deadline|截止期限
deadlock|死結
debugger|除錯程式
december|十二月
decipher|解開密文
decision|決策
decorate|裝飾
decouple|解碼
decrease|減少
dedicate|專注
deep red|深紅
deeppink|深粉紅
defaults|預設值
deferred|已延緩
degraded|降級
delaware|德拉瓦語
delegate|委派
deletion|刪除
delivery|遞送
demangle|解讀
denylist|拒絕名單
deployed|已部署
describe|描述
deselect|取消選取
designee|被指派者
designer|設計工具
detailed|細部
detected|偵測到
detector|偵測器
diagnose|診斷
diagonal|對角
dialogue|對話
diameter|直徑
diaspora|僑散
digitize|數位化
dilation|膨脹
diminish|減損
dingbats|裝飾符號
dinosaur|恐龍
directed|導
directly|直接
director|導演
disabled|已停用
disagree|不一致
disallow|不允許
disaster|災難
disclaim|放棄
disclose|透露
discount|折扣
discover|探索
discrete|離散
diskette|磁片
dismount|卸載
dispatch|派送
displace|置換
dissolve|溶解
distance|距離
distinct|明確的
dividend|被除數
division|除法
djibouti|吉布地
dockable|可停駐
document|文件
doing so|如此做
dominica|多米尼克
donation|捐款
dot size|圓點大小
download|下載
downtime|宕機時間
downward|向下
drag out|拖出
drawings|描繪
drop-out|掉出
droplets|水滴
due date|截止日期
duployan|杜洛耶
duration|持續時間
dyslexia|閱讀障礙
dzongkha|宗卡語
earphone|耳筒
easymove|易移模式
editable|可編輯
edititon|版本
egyptian|古埃及語
eject cd|光碟退片
ejecting|射出
elevator|電梯
eleventh|第十一
eligible|合格
ellipsis|省略符號
embedded|嵌入式
embossed|浮凸
emission|發射
emotions|表情符號
emphasis|強調
employee|雇員
emulator|擬真器
emulsion|乳劑
en-route|在路線中
encipher|譯為密文
enclosed|附件
end user|一般使用者
endorder|最終次序
endpoint|終點
engineer|工程師
engraved|雕刻
entering|進入
envelope|信封
ephemera|蜉蝣
epigraph|題辭
equal to|等於
equality|相等
equalize|均化
equation|方程式
equijoin|等聯結
erasable|可抹除的
error in|時發生錯誤
escalate|升高
esoteric|深奥的
especial|特別
estimate|估計
estonian|愛沙尼亞語
ethernet|乙太網路
ethiopia|衣索比亞
ethiopic|衣索比亞語
etruscan|伊特魯里亞語
european|歐洲的
evaluate|評估
everyday|每日
everyone|每一個人
examiner|審查器
exchange|交換
exercise|練習
existent|存在的
existing|現有
expedite|加速
explicit|明確的
explorer|檔案總管
exponent|指數
exporter|匯出器
exposure|曝露
extended|擴充
extender|擴充項
external|外部
extruder|擠壓器
facility|機能
fade out|淡出
faeroese|法羅語
failover|容錯移轉
failsafe|安全模式
failsoft|軟性故障
fair use|合理使用
falkland|福克蘭
fall off|掉落
fallback|侯補
far from|距離很遠
favorite|我的最愛
featured|特色
february|二月
feedback|反饋
few days|幾天
few more|多一點
fiducial|基準
filament|塑料絲
filename|檔名
filepath|檔案路徑
filesize|檔案大小
filespec|檔案規格
filetype|檔案類型
fileview|檔案檢視
filipino|菲律賓語
fill out|填寫
filmroll|膠卷
finalize|完成
find out|找出
find the|找到
finetune|微調
firewall|防火牆
firmware|韌體
fixation|定位
flashing|閃動的
flatness|平度
flatworm|渦蟲
flexible|多變
floating|浮動
flowline|流線
folklore|民俗音樂
follower|跟隨者
followup|跟隨
fontface|字體
fontname|字型名稱
fontwork|美術字型
footnote|註腳
for free|免費
for help|以獲得說明
for more|以獲得更多
for most|於多數
forecast|預報
foreword|序言
forward:|轉寄：
forwards|向前
founding|創始
fraction|分數
fragment|片段
frameset|頁框組
free-run|自由運行
freehand|徒手畫
freeware|免費軟體
friction|摩擦
friendly|友善
friulian|弗留利語
frontend|前端程式
fulfulde|福福德語
full url|完整網址
fullname|全名
fulltext|全文
function|函式
furigana|假名註解
further,|進一步來說，
galician|加里斯亞語
garantee|保證
garbling|弄壞
generate|產生
geometry|位置與尺寸
georgian|喬治亞語
geranium|鮮紅
gigabyte|十億位元組
git help|git help
globbing|萬用匹配
glossary|字彙
go ahead|前進
go there|到那裡去
goldfish|金魚
gorgeous|華麗的
governed|主控
gradians|梯度
gradient|梯度
grapheme|音素
graphics|美工繪圖
graphite|石墨
grateful|感激
greeting|問候
grounded|接地的
group by|群組依據
grouping|分組
gtk-edit|編輯
gtk-help|求助
gtk-save|儲存
guernsey|根息島
guidance|指引
gujarati|古吉拉特語
gurmukhi|果魯穆其語
gwich'in|庫臣語
hairline|纖線
halation|光暈
halftone|半調
hand set|手持裝置
handbook|手冊
handheld|手持
handling|處理
hardcode|寫死
hardcore|強硬風格
harddisk|硬碟
hardlink|硬式鏈結
hardware|硬體
hatching|陰影線
hawaiian|夏威夷的
headline|頭條
heads up|當心
hebrides|赫布里
hellenic|希臘
help you|協助您
hieratic|神職的
high-end|高階
hiragana|平假名
historic|史蹟的
holdover|自持
hologram|全像
holy see|教廷
homepage|首頁
honduras|宏都拉斯
honeydew|蜜瓜白
hostname|主機名稱
hot spot|作用點
hotspare|緊急備援
hour ago|小時之前
housefly|家蠅
how long|多久
how many|有多少
humanity|人道
ichitaro|一太郎
icon set|圖示集
ide disk|IDE 磁碟
identify|識別
identity|身分
ideogram|表意文字
imagemap|影像映射
imperial|皇室
implicit|隱含的
importer|匯入器
in doubt|有疑慮
in drive|在光碟機中
in front|前方
in place|適當
inactive|非現用
incident|事故
incoming|收到的郵件
increase|增加
indicate|指示
indirect|間接
industry|工業
infinite|無限大
informal|非形式
infrared|紅外線
infringe|侵害
inherent|固有的
initials|縮寫
initiate|啟動
insecure|不安全
instance|實例
instated|復原
integral|積分
intended|預想的
interact|互動式操作
intercom|對講機
internal|內部
internet|網際網路
interval|間隔
into two|為雙
intranet|企業內部網路
inverter|變頻器
investor|投資者
invoiced|已開發票
involved|投身
issuance|發佈
it hurts|好痛
it reads|內容為
iterator|迭代器
japanese|日語
jar file|JAR 檔案
javanese|爪哇語
johnston|約翰斯頓
joystick|搖桿
judgment|判決
just now|就是現在
karelian|卡累利阿語
kashmiri|喀什米爾語
katakana|片假名
kayah li|克耶李文
key code|鍵碼
key pair|金鑰對
key type|關鍵字類型
keyboard|鍵盤
keypress|按鍵
keypunch|按鍵打孔機
khutsuri|格魯吉亞文
kilobyte|千位元組
kimbundu|金本杜語
kiribati|吉里巴斯
kombucha|康普茶
kosraean|科斯拉伊語
kuanyama|寬亞瑪語
kwanyama|寬亞瑪語
l1 inst.|L1 指令
landmark|地標
language|語言
laothian|寮語
last day|前一天
latitude|緯度
laughing|大笑
launcher|啟動器
lavender|淡紫
lebanese|黎巴嫩
let's go|讓我們去
level %s|第 %s 關
leverage|拼搏
lezghian|列兹金語
licensee|授權者
licensor|授權者
lifetime|生命期
ligature|連體字
light up|打光
likewise|而且
line cap|線條頂端
line-out|線出
linear a|線形文字 A
linear b|線形文字 B
linefeed|送列鍵
link set|鏈結集
list all|列出所有
list box|列表方塊
list the|列出
listener|聆聽程式
live usb|自活閃碟
loadable|可載入的
localeid|語區識別碼
locality|局部
localize|本地化
location|位置
locktype|鎖定類型
log file|記錄檔
log into|登入
logical"|邏輯
login as|登入為
look for|找尋
loopback|回送
lossless|無損失
low pass|低通
madurese|馬都拉語
magazine|雜誌架
magnetic|磁性
mahajani|瑪哈賈尼文
mailstop|收發室
mainline|主線
maintain|保持
maithili|米德勒語
makefile|建置檔
makeover|打扮
malagasy|馬達加斯加語
malaysia|馬來西亞
maldives|馬爾地夫
malvinas|馬維娜斯
man page|線上手冊
mandaean|曼迪因教派
mandarin|官話
mandingo|曼丁哥語
manifest|清單
manifold|複本
manipuri|曼尼普爾語
mantissa|尾數
manually|手動
maryland|馬里蘭
masthead|報頭
material|材料
maturity|成熟度
maurette|明紫
max size|最大尺寸
maximize|放到最大
maximum"|最大值
may also|也可以
may only|衹可以
meanline|肩線
measures|措施
megabyte|百萬位元組
mentions|提及次數
menu bar|功能表列
merengue|美倫格風格
meridian|子午線
meroitic|麥羅埃語
metadata|後設資料
metadisk|中繼磁碟
metafile|中繼檔案
metalink|中繼鏈結
metering|測量
metrical|公制
midnight|午夜
mimetype|網路媒體類型
mind the|小心
minidump|小型傾印
minimize|縮到最小
mirrored|翻轉的
mismatch|不符合
misorder|序誤的
misspell|拼錯
mitigate|緩解
mnemonic|助憶
mobility|行動
moccasin|鹿皮黃
modality|成像方式
modeless|非強制回應
modeling|建立式樣
modeller|建模器
moderate|調控
modified|已修改
modifier|修飾鍵
moldavia|摩爾達維亞
moldovan|摩爾多瓦語
molecule|分子
momentum|衝力
mongolia|蒙古
monotone|單調的
montreal|蒙特婁
morphing|圖形交接
move top|移動到頂端
movement|移動
multibus|多重匯流排
multimap|多重映射
multiple|多重
multiset|多重集
must not|必須不
myanmar"|緬甸語
named %s|名為 %s 的
namelist|名稱列表
national|國家的
nautical|海制
navigate|導覽
negation|否定
negative|負
neighbor|鄰節點
netgroup|網路群組
new line|換列
new wave|新浪潮
nickname|暱稱
nintendo|任天堂
non-leaf|非尾節點
non-zero|非零
normally|正常
northern|北
not both|並非兩者
not like|不同於
not only|不衹
not used|未使用
notation|記法
notebook|筆記型電腦
noteless|無節點
notifier|通告員
november|十一月
nowadays|如今
null key|空鍵
nullable|可為空
numbered|已編號
nyamwezi|尼揚韋齊語
nyankole|尼揚科萊語
obsidian|黑曜石
obsolete|過時的
occupant|室友
occupied|佔據
odorless|無臭
off-link|離鏈
official|正式的
offprint|抽印
ol chiki|桑塔利文
omission|省略
on right|右側
on topic|切題
on-board|在主機板上的
on-topic|話題
one stop|一次滿足
one user|一位使用者
openness|開放精神
operator|運算子
opposite|對面的
optimize|最佳化
optional|可選的
or group|或群
or later|或後續版本
or lower|或更低
or newer|或更新版本
ordering|定序
ordinary|尋常
organize|安排
original|原來的
ornament|裝飾
ossetian|奧塞提語
out-band|帶外
out-only|限輸出的
outbound|輸出向的
outgoing|外送的郵件
outright|立即
overburn|超量燒錄
overflow|溢位
overhang|突出部分
overhead|過度
overline|上線
overload|過載
overlong|過長
override|凌駕
overrule|駁回
overtime|加班
overview|概觀
packager|套件製作者
page out|移出分頁
page set|頁集
pagedown|下頁
paginate|編頁碼
painting|繪圖
pairwise|成對
pakistan|巴基斯坦
pampanga|潘帕嘉語
pangolin|穿山甲
panorama|全景
paradigm|範例
paraguay|巴拉圭
parallel|平行
parthian|帕提亞文
particle|粒子
passport|護照
password|密碼
paste as|貼上為
pathname|路徑名稱
payphone|公用電話
pelement|虛擬元件
penumbra|半影
people's|人民
personal|個人的
petition|請願
phags-pa|八思巴文
phaistos|費斯托斯文
phonetic|注音符號
physical|物理
pilipino|菲律賓語
pingback|回敲
pipeline|管線
pitcairn|皮特肯島
pixelize|像素化
platform|平臺
platinum|白金
playable|可播放
playback|播放控制
playlist|播放列表
pleasing|美觀
plug-ins|外掛程式
poemline|詩列
polarity|極化方位
polyline|折線
pop-folk|流行民歌
populate|加添
portable|可移植的
portrait|肖像
portugal|葡萄牙
position|位置
positive|正面的
possible|可能的
possibly|可能會
post-gap|後置間隙
postcard|明信片
postings|賬目
postpone|擱置
powerful|強大的
powering|動力
practice|練習
pre-link|鏈結前
pre-poll|輪詢前
preadmit|預先住院
preamble|前言
precious|寶貴
preclude|排除
preening|整飾
prelight|預視
presence|存在
preserve|保留
pressure|壓力
prestore|預儲
previous|上一個
printout|列印輸出
prior to|之前
priority|優先權
prisoner|囚犯
private"|私人的
probably|或許
profiler|效能評測器
proforma|一覽表
progress|進度
prohibit|禁止
prologue|序幕
promptly|迅速
property|性質
protocol|協定
protrude|突出
provider|提供者
province|省
punitive|懲罰的
purchase|購買
qt based|基於 Qt 的
quantity|量
quantize|離散化
question|問題
quit now|馬上離開
radicals|部首
radicand|被開方
raindrop|雨滴
ram disk|RAM 磁碟
rational|有理的
raw data|未經處理資料
raw-mode|原始模式
re-enter|重新輸入
read out|讀出
readable|可讀取
readonly|唯讀
ready to|準備好
reappear|重新出現
reattach|重新附接
receiver|收件者
recenter|重新置中
recently|最近
recorder|燒錄機
recovery|復原
recreate|重建
recycler|資源回收筒
redefine|重新定義
redeploy|重新部署
redirect|重新導向
reencode|重新編碼
refer to|參考
referent|參考
referral|參照
reformat|重新格式
register|註冊
registry|註冊表
reinsert|重新插入
reinvent|重新發明
rejector|拒絕者
relation|關聯
relative|相對的
relevant|相關的
reliance|信賴
religion|宗教
relocate|重定址
remember|記住
reminder|提醒訊息
renderer|潤算器
renumber|重新編號
repeater|中繼站
reply-to|回信地址
repo url|套件庫網址
reporter|報告者
republic|共和國
required|必要項
rerouted|再次設定路線
resample|重新取樣
research|研究
reserved|保留的
resident|常駐
residual|殘餘
resilver|重新同步
resolver|解析器
resource|資源
response|回應
restrict|限制
retrieve|取回
reviewer|校閱者
revision|修訂
rhodesia|羅得西亞
rightful|合法的
ringtone|鈴聲
roadbook|路線圖
roll out|滑出
rollback|回捲
rollover|滑鼠變換影像
romanian|羅馬尼亞語
rotating|旋轉的
rotation|旋轉
round up|捨進
round-up|進位
row-wise|逐列
run code|執行階段程式碼
run-time|執行時期
one-time|單次
runlevel|執行層級
sagittal|縱切面
sampling|取樣
sandwich|三明治
sanitize|淨化
sanskrit|梵語
sapphire|藍寶石
sarajevo|塞拉耶佛
saturate|飽和
saturday|週六
save all|全部儲存
scan for|掃描有無
scenario|情景
schedule|排程
scotland|蘇格蘭
scottish|蘇格蘭的
scramble|攀爬
scribble|草寫
seagreen|海藻綠
seamless|無縫
seashell|貝殼白
secondly|其次
security|安全
see also|同時參看
seek for|尋求
seekable|可尋取的
selected|已選
selector|選擇器
selenium|硒
semantic|語意
semibold|半粗體字
send all|全部發送
sendable|可發送
sensible|明智的
sentence|句子
separate|分隔
sequence|序列
sessions|期間
set font|設定顯示字型
set here|在這裡設定
set type|集合型式
setswana|茨瓦納語
settings|設定項目
severity|嚴重性
shadowed|帶陰影
shift up|上移
shift-in|移入
shilling|先令
shipping|運輸
shopping|購物
shortcut|快捷鍵
show all|全部顯示
show off|顯示出
showcase|櫥窗
shredder|撕碎
shutdown|關機
sicilian|西西里語
sideways|側向
sign off|簽核
silently|靜默地
simplify|簡化
simulate|模擬
singular|單
sitewide|全站
skeleton|架構
skip all|全部跳過
sky blue|天藍
slavonic|斯拉夫語
slidebar|滑動桿
slightly|輕微地
slitting|撕裂
slovakia|斯洛伐克
slovenia|斯洛維尼亞
slow jam|慢果醬風格
smallest|最小
snapshot|快照
softlink|軟式鏈結
softness|柔軟度
software|軟體
solarize|日光作用
solution|解決方案
somebody|某人
sometime|某時
somewhat|有些
sortable|可排序的
southern|南
spanish"|西班牙語
specfile|規格檔
specific|特定的
specimen|樣本
spectrum|光譜
speed up|加速
spelling|拼寫
spent on|花在
splatter|結巴說話
splitter|分隔器
spooling|暫存作業
spripper|拼版
spurious|偽造的
squiggly|潦草的
stairway|樓梯
stand by|待命
standard|標準
starring|主演
start up|啟動
stateful|具狀態的
stellate|星形
step one|步驟一
step out|逐步跳出
step two|步驟二
stepping|製程
straight|平直
strategy|策略
strength|強度
stripper|拆除器
stronger|更強的
subagent|子代理程式
subarray|子陣列
subclass|子類別
subfield|子欄位
subgroup|次群組
subgrove|子樹叢
subitems|子項目
sublayer|子層
submerge|淹沒
subpanel|輔助面板
subparse|次剖析
subquery|子查詢
subtable|子表格
subtitle|字幕
subtotal|小計
subtract|減去
suitable|適合的
sumerian|蘇美語
superior|優越的
superset|超集合
supplied|給定
supplier|供應者
supplies|百寶箱
suppress|抑制
surfaced|浮現
surfaces|平面
suriname|蘇利南
surround|圍繞
svizzera|瑞士
swatches|色樣
swinging|擺動
swipe to|滑動以
swipe up|向上滑動
switcher|切換器
syllabic|音節
symbolic|符號
symmetry|對稱
symphony|交響曲
synopsis|概述
synthpop|新浪潮電子
tab stop|跳格停駐點
tabulate|跳格
tagbanwa|菲律賓－塔格板瓦語
tahitian|大溪地語
tai tham|老傣文
tai viet|越南傣文
takeover|接手
talkback|回報
tamashek|泰瑪歇克語
tanzania|坦尚尼亞
tape out|設計定稿
tapeworm|絛蟲
task bar|工作列
tax rate|稅率
tear-off|移動式
teleplay|電視劇
teletype|電傳打字
template|模本
tends to|傾向於
terminal|終端機
tertiary|第三方
text box|文字方塊
textfile|文字檔案
thailand|泰國
that are|所
that is,|也就是說，
that you|您
there is|有
this may|這也許會
this one|這一個
thriller|恐怖片
thriving|旺盛的
throttle|扼殺
thursday|週四
tifinagh|提非納字母
tigrinya|提格利尼亞語
time out|逾時
timeline|時間軸
timezone|時區
tired of|厭倦了
titlebar|標題列
to abort|以放棄
to force|以強制
to front|於序頁
to house|掌控
to reach|到達
to right|往右
to start|啟始
together|一齊
tokenize|字組化
tolerant|耐受度
tomorrow|明天
too many|太多
too much|太多
tool bar|工具列
top left|左上
top-down|由上而下
top-most|置頂
toplevel|最上層
topology|拓樸
touchpad|觸控板
tracking|追蹤
tradeoff|掉換
trailing|尾隨
transfer|轉移
transmit|傳輸
trashcan|回收筒
trashing|回收
traverse|遍歷
tray out|托盤滑出
treasury|國庫
treeview|樹狀檢視
triangle|三角
trigraph|三併詞
trinidad|千里達
trip-hop|迷幻舞曲
truncate|截斷
tumbling|翻轉
tune-ups|調校
turn off|關閉
tutorial|教學課程
tuvinian|圖瓦尼安語
tweening|中間計算
two-step|兩階段
typeface|字體
typefont|字樣
typenoun|活字
ugaritic|烏加里特語
umbrella|大傘
unboxing|開箱
undefine|未定義
undelete|復原刪除
undeploy|未部署
underbar|下條
underrun|淘空
undoable|可復原的
unencode|未編碼
unexport|取消匯出
unfollow|取消跟隨
unindent|復原縮排
unknown"|不明的
unlikely|不大可能
unpaired|未成對
unsatify|無法滿足
unscroll|復原捲曲
unselect|取消選取
unsigned|無正負號
unsorted|未排序
unstable|不穩定的
untitled|無標題
unusable|無法使用
unwanted|討厭的
upcoming|即將來臨的
uploader|上傳者
upstream|上游
upturned|顛倒
usb disk|閃碟
use both|同時使用
used for|用於
userlist|使用者串列
username|使用者名稱
vacation|假期
validate|驗證
validity|有效
valuator|設值器
variable|變數
variadic|可變
variance|變動
velocity|速度
verbatim|逐字地
verbiage|冗詞
verified|已經核實
verifier|核實者
vertical|垂直
vertices|頂點數
vibrator|擺動器
video in|視訊輸入
videotex|電傳視訊
viet nam|越南
viewport|檢視區
virginia|維吉尼亞
virtuoso|鑒賞家
vividian|翠綠
volatile|揮發的
wait for|等待
warranty|擔保
watchdog|監視程式
waveform|波形
wear out|破損
web page|網頁
web site|網站
weekdays|週間
weighted|加重
western"|西歐語言
what new|新增功能
whenever|每當
whiteout|白化
wideband|廣頻
widebyte|寬位元組
wildcard|萬用字元
wireless|無線
wishlist|願望列表
withdraw|撤回
withdrew|已撤回
withhold|保留
wordwrap|換列
work day|工作天
workbook|工作簿
workflow|工作流程
workload|工作負荷量
workshop|工作室
workweek|工作週
wrapping|環繞
writable|可寫入
write to|寫入
writings|著作
wrote to|寫入了
xor gate|互斥或閘
you help|您協助
you join|您參與
your own|您自己的
yourself|您自己
yugoslav|南斯拉夫
zero-pad|用零填補
zerofill|鑲入零字元
zimbabwe|辛巴威
zip code|郵遞區號
zoom out|縮小
"for more|要獲得更多
"portrait|直印
"suppress|不列印
%'d items|%'d 個項目
-en twice|了兩次
-have -en|已
-have not|沒
3rd party|第三方
4-channel|4 聲道
a certain|某一
a copy of|的副本
a correct|正確
a missing|缺少的
a new one|一個新的
a running|執行中的
abkhazian|亞布卡薩語
above the|之上
accessory|附屬應用程式
according|根據
acid jazz|迷幻爵士
acid punk|迷幻龐客
activator|活化子
add it to|將它加入
adjective|形容詞
admintool|管理工具
admission|住院
advantage|優點
adventure|冒險
advertise|通告
affiliate|附屬
afrikaans|南非語
afterward|向後
afterword|後記
age group|年齡層
aggregate|聚合
agreement|合約
aim right|向右瞄準
alchemist|術士
algebraic|代數
algegraic|代數型
algorithm|演算法
aliceblue|艾莉斯藍
alignment|對齊
allegedly|據傳
allocator|配置器
allowable|被允許的
allowance|限額
allowlist|允許名單
alongside|伴隨
alternate|交替
ambiguity|模稜兩可
ambiguous|模稜兩可的
amendment|修正
ampersand|及號
amplitude|振幅
amusement|娛樂
anatolian|安納托利亞
ancillary|輔助
and go to|並前往
and so on|…等等
and their|與其
animation|動畫
annoyance|討厭
anonymous|匿名
antiglare|抗反光
apologies|對不起
appear to|看來
appliance|設備
apply for|申請
aragonese|阿拉貢語
arbitrary|任意
arccosine|反餘弦
argentina|阿根廷
argentine|阿根廷的
aromanian|阿羅馬尼亞語
arrow key|方向鍵
as before|一如以往
as unread|為未讀
ascending|遞升
ascension|阿森松島
ascertain|確認
ask me to|要求我
assembler|組譯器
assistant|助理
associate|關聯
assurance|保證
at a time|一次
at cursor|游標所在
atomicity|不可分割性
attendees|與會者
attending|出席
attention|注意
attractor|吸子
attribute|屬性
audit log|稽核記錄
australia|澳大利亞
authority|授權
authorize|授權
auto crop|自動裁切
auto-hide|自動隱藏
auto-name|自動命名
auto-save|自動儲存
autocheck|自動檢查
autoinput|自動完成
automatic|自動
automaton|自動裝置
automount|自動掛載
autoreply|自動回覆
autotrace|自動追蹤
autovalue|自動數值
autowidth|自動調整寬度
auxiliary|輔助設備
available|可用
back view|後視圖
backcolor|背景顏色
backlight|背光
backplane|背面機板
backslash|反斜線
backspace|退格
backstyle|背景樣式
backtrace|返回
backtrack|回溯
backwards|向後
bandwidth|頻寬
bar chart|長條圖
bar graph|長條圖
base line|基線
base size|基本大小
bass down|減弱低音
bassa vah|巴薩瓦赫字母
baud rate|鮑率
be absent|缺乏
be issued|發放
be just a|僅僅是一個
be not an|並非
be slated|預定
beginning|開頭
behaviour|行為
belong to|屬於
below the|之下
benchmark|效能評測
bilateral|雙邊
bilingual|雙語言
billboard|告示牌
birthdate|出生年月日
blacklist|黑名單
blocklist|區塊列表
blocksize|區塊大小
bluegrass|藍草音樂
bluetooth|藍牙
boardcode|字碼板
bold font|加粗字型
boomerang|迴力棒
boot file|啟動檔案
bootstrap|啟動程式
bother to|去操心
bound for|開往
brand new|嶄新
breakdown|分解
breakouts|突破
briefcase|公事包
broadband|寬頻
broadcast|廣播
broken up|拆散
bugreport|錯誤報告
bulgarian|保加利亞語
bulk edit|大量編輯
burlywood|原木色
by author|依作者設定
by folder|依資料夾
by number|依編號
by server|依伺服器
by status|依狀態
byzantine|拜占庭
cadetblue|藏青
calculate|計算
calibrate|校準
call back|回呼
cambodian|柬埔寨語
came from|是來自
can still|仍然能夠
candidate|侯選
canonical|規範的
capheight|大寫高度
caps lock|大寫鍵
card game|紙牌遊戲
carefully|仔細
caribbean|加勒比海
carribean|加勒比海
carry out|執行
cartridge|卡匣
castilian|卡斯提爾
catalogue|型錄
catalonia|加泰羅尼亞
caucasian|高加索
cd-writer|光碟燒錄機
cent sign|分幣號
centuries|數百年
challenge|挑戰
change to|變更為
changelog|變更記錄
character|字元
charactor|字元
cheatcode|密技碼
check box|核取方塊
check for|檢查有無
check key|檢核鍵
check out"|簽出
check out|檢閱
checkered|方格的
checklist|檢核列表
checkword|檢查字
chipewyan|奇佩維安語
chiselled|鑿光
chit chat|閒聊
chocolate|巧克力色
christmas|聖誕
circle in|圓形收縮
circulate|流通
classical|古典音樂
classpath|類別路徑
clear all|全部清除
clickable|可點選
client id|客戶識別碼
clinician|臨床醫師
clip file|素材檔案
clipboard|剪貼簿
clockwise|順時針
close all|全部關閉
code base|代碼基底
code page|字碼頁
codepoint|程式碼點
cognitive|認知
coherence|連貫性
collation|定序
collector|收集器
collision|碰撞
color bar|顏色列
color set|顏色集
colorfade|褪色
colorless|無色
combo box|複合方塊
come back|回來
commander|指揮官
committee|委員會
committer|定稿者
community|社群
comparand|比較元
competent|稱職的
complaint|抱怨
completed|已完成
compliant|相容
component|成分
composite|合成
condition|條件
configure|組配
confusion|困惑
congruent|全等
connected|連線
connector|連接器
consensus|共識
constance|常數
constrain|等比例
construct|建構
container|容器
continued|一直以來的
converter|轉換器
cope with|應付
coproduct|互積
copyright|著作權
core dump|記憶體傾印
core file|記憶體檔案
coroutine|協常式
corporate|組織
correctly|正確
corrupted|已損壞
cotangent|餘切
could not|無法
countdown|倒數
cpu-bound|運算吃重
criterion|條件
crossfade|淡入淡出
crosshair|十字準線
crossover|跨界音樂
crosstalk|串音
cue sheet|提示表
cuneiform|楔形文字
currently|目前
curvature|曲率
customize|自訂
dangerous|危險
dark blue|深藍
dark gray|深灰
darkgreen|深綠
darkkhaki|深卡其色
dashboard|看板
data base|資料庫
data rate|資料傳輸率
data sink|資料接收點
datapilot|資料助理
datasheet|資料工作表
de-assert|解主張
dead code|無作用程式碼
dead keys|廢鍵
dead-zone|死角區
debugging|偵錯
deceptive|詐騙的
decide to|決定要
decompile|反編譯
decrement|遞減
dedicated|專屬
defaulted|缺席
defective|有缺陷的
deficient|匱乏
deflector|偏轉器
deinstall|反安裝
dejagging|消除鋸齒線
delegates|代理人
delimited|界定
delimiter|分隔符號
demarshal|除封送
demo tape|小樣
depend on|取決於
dependent|附屬
deprecate|揚棄
descender|下緣部分
designate|指明
despeckle|除斑
detective|偵測
determine|確定
developer|開發者
diacritic|變音符
diaeresis|分音符號
diagnosis|診斷
diasporas|僑民
different|不同的
difficult|困難
diffusion|擴散
digitizer|數位化器
dimension|尺寸
direction|方向
directive|指令
directory|目錄
disappear|消失
discharge|放電
discovery|探索
disengage|分離
disk full|磁碟已滿
diskspace|磁碟空間
disparage|貶低
disparate|相異的
dispersed|分佈式
disregard|無關
dot scope|點狀
downgrade|降級
drag over|拖過
dravidian|達羅毗荼語
draw game|平手
draw text|繪圖文字
drive the|推動
drop down|下拉
drop-down|下拉式
drum solo|鼓獨奏
due today|今天到期
duplicate|複製
dvd image|DVD 映像檔
each hour|每小時
each time|每次
ecosystem|生態系統
education|教育
effective|有效
efficient|有效率
elaborate|闡述
elevation|升降
eliminate|消除
ellipsize|省略
ellipsoid|橢圓體
elsewhere|其他情況下
emergence|突現
emergency|緊急
emoticons|情緒圖案
emphasize|強調
employing|會用到
empty map|空映射
empty set|空集合
emulation|擬真
enclosure|封閉
encompass|內含
encounter|遇到
encourage|鼓勵
end angle|最終角度
end track|終點軌段
end-point|端點
engage in|從事
enum-type|枚舉類型
enumerate|枚舉
ephemeral|短暫的
ephemeris|星曆表
equalizer|等化器
equipment|裝備
eradicate|根除
ergonomic|人體工學
erroneous|錯誤的
error bar|誤差線
error log|錯誤記錄
escalator|電扶梯
esperanto|世界語
essential|要點
establish|建立
etiquette|禮儀
euclidean|歐式幾何的
eurodance|歐式舞曲
event log|事件記錄
ever lost|一旦遺失
everybody|所有人
evolution|演化
exactness|精確
exaggrate|誇大
excellent|優秀
exception|異常
exclusion|互斥
exclusive|互斥
exclusively|獨占地
execution|執行
exemplary|示範的
exhausted|已耗盡
existence|存在
existing"|存在
exit code|退出代碼
expansion|擴展
expedient|權宜
expertise|專業知識
explosion|爆炸
export as|匯出為
export to|匯出至
expressly|明白地
extension|延伸
extention|擴充
extremely|極度地
extrusion|擠壓
facsimile|傳真
factorial|階乘
factorize|因數分解
failed to|無法
fall back|降抵
fall down|掉下
far right|最右側
fast play|快播
favourite|收藏
fifteenth|第十五
filestore|檔案庫
filevault|檔案保險箱
fill type|填色類型
filled in|填寫
film roll|膠卷
filmstrip|影片片段
filterbar|篩選列
filtering|篩選
financial|金融
find next|找下一個
find what|尋找目標
firebrick|磚紅
first one|第一個
first two|前兩個
firstname|名
flat file|平面檔案
flip-flop|正反器
flowchart|流程圖
fluidness|流暢度
focusrect|定焦矩形
folk-rock|民歌搖滾
follow us|跟著我們
following|跟隨中
font face|字體
font hint|字型修飾
font size|字型尺寸
fontforge|字型鑄造廠
footprint|佔用空間
for input|做為輸入
for short|簡稱
for usage|以了解用法
forbidden|禁止
forecolor|前景顏色
foregoing|前述
forget to|忘記
form feed|表格饋送
formalize|形式化
formatter|格式編排器
fortnight|兩週
forwarded|已轉信
framework|框架
free page|可用頁面
freestyle|自由樣式
frequency|頻率
front end|前端
frontpage|序頁
full link|完全鏈結
full name|全名
full page|整頁
full path|完整路徑
full size|完整大小
full stop|句點
fullwidth|全形
fuzziness|模糊性
gainsboro|亮灰
game over|遊戲結束
gamma ray|伽瑪射線
generator|產生器
geometric|幾何
gibraltar|直布羅陀
given for|施用於
go to end|到終點
goldenrod|金黃
good luck|祝您好運
gorontalo|哥倫打洛語
goto line|前往列號
graduated|漸變的
graphical|圖形
gray-code|格雷碼
grayscale|灰階
great way|最佳方式
greenland|格陵蘭
grenadine|石榴紅
greyscale|灰階
grid cell|分格儲存格
gridlines|網格線
groupname|群組名稱
groupware|群組軟體
guarantee|保證
guatemala|瓜地馬拉
guesswork|猜測
guideline|指引
guillemet|書名號
half size|一半大小
halfwidth|半形
handshake|交握
handwheel|手動轉輪
hard disk|硬碟
hard rock|硬式搖滾
hard work|努力成果
hard-code|硬式編碼
hash mark|井字號
hashemite|哈什米
have both|同時有
have only|衹有
headphone|耳機
help with|幫忙
hereafter|之後
hereunder|依此
heuristic|試探
hibernate|休眠
hierarchy|階層結構
highlight|突顯
himachali|喜馬偕爾語
hiri motu|希里莫圖語
histogram|長條圖
hold down|按下
hold time|持有時間
home page|首頁
hong kong|香港
honor the|尊重
hope that|希望
horoscope|星座運勢
hot spare|緊急備援
how often|多久會
hundredth|百分之一的
hungarian|匈牙利語
hyperlink|超鏈結
hypertext|超本文
i/o-bound|輸出輸入吃重
icelandic|冰島語
id number|識別號碼
identical|相等的
image map|圖像映射
imagemask|影像遮罩
imaginary|虛數
imbalance|不平衡
imitation|模仿
immediate|即時
immutable|不可變的
impedance|阻抗
impedence|阻抗
implement|實作
important|重要的
in %d day|於 %d 天後
in %i day|於 %i 天後
in %s day|於 %s 天後
in no way|完全不會
in pixels|以像素計量
in points|以像點計量
inclusion|包含
incognito|無痕
incorrect|不正確的
increment|遞增
indemnify|賠償
indianred|印度紅
indicator|指示器
indonesia|印度尼西亞
infection|感染
inhibited|禁用
initiator|初始器
inpatient|住院病患
installed|已安裝的
installer|安裝程式
institute|研究所
integrate|整合
integrity|正直
intend to|想要
intensity|強度
intercept|截取
interests|興趣
interface|介面
interlace|交錯
interlock|互鎖
interpret|解譯
interrupt|插斷
intersect|交集
interwork|互動
intestine|腸
introduce|引介
intuitive|直覺
inuktitut|伊努特語
invariant|不變量
inventory|庫存
inversion|反逆
investing|投資
invisible|隱形的
ip number|IP 編號
isolation|隔離性
isometric|等量
isotropic|等向
issued to|發放對象
it leaves|它離去
iteration|迭代
iterative|迭代的
java code|爪哇程式碼
job title|職稱
join line|聯結線
jumbogram|巨封包
justified|左右對齊
kabardian|卡巴爾德語
kashubian|卡舒比語
key frame|主要框架
key plate|主色盤
key value|關鍵值
keyframes|關鍵影格
keystroke|按鍵
keyswitch|鑰匙開關
kharosthi|佉盧文
khotanese|和闐語
khudawadi|信德文
knowledge|認知
labyrinth|迷宮
landscape|地景
languages|語言集
laplacian|拉普拉斯
last line|最後一列
last name|姓氏
last page|最後一頁
last read|最近讀過
last time|最後一次
last week|前一週
last year|前一年
lawngreen|草綠
lead size|導語大小
less than|少於
levelsets|關卡組合
liability|責任
librarian|管理器
life-time|生命周期
lifecycle|生命周期
light red|淺紅色
lightblue|淺藍
lightcyan|淺青綠
lightened|已減輕
lightgrey|淺灰
lightness|亮度
lightpink|淺粉紅
limburgan|林堡語
limegreen|檸檬綠
line down|下移一列
line feed|送列
line tool|線段工具
line wrap|自動換列
linewidth|列寬
link down|鏈結中斷
link type|鏈結型式
list only|衹列出
listen to|聆聽
listindex|列表索引
literally|字面上
lithuania|立陶宛
load copy|載入副本
local bus|區間車
localpart|本地部分
lock file|上鎖檔案
log in as|登入為
log watch|觀看記錄檔
logarithm|對數
logged in|登入
long bond|長銅版紙
long form|長式
long term|長期
long-term|長時期
longevity|長壽
longitude|經度
look like|看起來像
lookahead|期望
low level|低階
low order|低序位
low-level|低階
low-order|低階
lowercase|小寫
lule sami|魯爾薩米語
luminance|亮度
macedonia|馬其頓
machanism|機制
magnitude|振幅
main body|本文
main menu|主選單
mainframe|大型主機
make link|建立鏈結
make sure|確定
malayalam|馬來亞拉姆語
malformed|異常的
malleable|延展性
man power|人力
mandatory|必要
marketing|行銷
maskedbox|格式編輯控制項
mastering|壓製
mauritius|模里西斯
meanwhile|同時
mechanism|機制
megaflops|百萬次浮點運算
melodrama|音樂劇
menu file|功能表檔案
menu item|功能表項目
messaging|傳訊
meta data|後設資料
microsoft|Microsoft
middleend|中階
migration|遷移
milestone|里程碑
millipede|馬陸
miniature|縮影
minimized|最小化的
mintcream|薄荷乳白
mirandese|米蘭德斯語
miscreant|異端
mistyrose|粉玫瑰紅
mnemonics|助憶符號
moderator|管理者
modulator|調變器
moldavian|摩爾達維亞語
mongolian|蒙古語
monologue|獨白
monospace|定寬
more than|超過
move down|向下移動
move left|向左移動
multibyte|多位元組
multicast|多重播送
multiplex|多路傳輸
multiuser|多使用者
multiview|多重檢視
nabataean|納巴泰文字
name only|僅顯示名稱
name type|名稱型式
name your|命名您的
namespace|命名空間
necessary|必要的
negerpunk|黑人龐克
neighbour|鄰居
networked|網路的
new-style|新樣式
newsgroup|新聞群組
newspaper|報紙
next page|下一頁
next time|下一次
next week|下週
next year|次年
nicaragua|尼加拉瓜
nick name|暱稱
no longer|不再
no select|沒有選擇
no to all|全部皆否
nominated|提名的
non empty|非空
non-ascii|非 ASCII
non-basic|非基本
non-blank|非空白
non-empty|非空
nonnative|非原生的
nonstatic|非靜態
normality|常態度
normalize|常態化
norwegian|挪威語
not empty|不空缺
not equal|不等於
not exist|不存在
not found|找不到
not known|不明
not saved|未儲存
notations|表示法
note that|要注意的是，
notorious|惡名昭張的
novel way|新奇的方式
nuevo sol|新索爾
null byte|空位元組
null type|空型式
number of|數量
numbering|編號
numerator|分子
numerical|數詞
obfuscate|模糊化
object to|反對
observers|觀察員
obviously|明顯地
occlusion|鎖閉
of course|當然
of itself|其本身的
off topic|離題
off-topic|題外
offensive|攻擊性
oil paint|油畫
old-style|舊式
olivedrab|淡綠褐
on demand|隨選
on or off|開或關
only once|衹一次
open with|開啟方式
operation|作業
or higher|或更高
orangered|橙紅
orderwire|維運聯絡
organiser|統籌者
organizer|主辦者
originate|發起
otherwise|否則
ourselves|我們自己
outerline|外框
outsource|外包
over time|逐漸
overhead"|開銷
overprint|套印
overrider|凌駕項
overshoot|越限
overwhelm|淹沒
overwrite|覆寫
ownership|所有權
oxidation|氧化
packaging|包裝
page down|向下一頁
pale blue|淡藍
palegreen|淡綠
palestine|巴勒斯坦
palmyrene|帕米瑞拉文字
pannonian|潘諾尼亞
paper jam|夾紙
paperless|無紙
paragraph|段落
parameter|參數
parenting|養育
partition|分割
pathdepth|路徑深度
patronage|贊助
peachpuff|粉桃紅
perfmeter|效能計數器
performer|執行者
permalink|永久鏈結
permanent|永久
perpetual|永遠的
pertinent|適切的
philipine|菲律賓
phone-out|話出
physician|醫師
pictogram|圖像文字
pictorial|圖象的
pie chart|圓餅圖
pie graph|圓餅圖
pie slice|扇形
pitchfork|耙子
pivotview|樞紐分析檢視
placement|放置位址
plaintext|明文
play back|播放
play game|玩遊戲
plenty of|大量的
pneumatic|氣動
pohnpeian|波那貝語
polishing|美化
poly-line|折線
polygonal|多邊形的
polytonic|多音調
portfolio|個人資料
post code|郵遞區號
postamble|後文
postboard|張貼欄
posterize|色調分離
potential|潛在的
power off|關閉電源
practical|實用
pragmatic|實效的
pre-build|組建前
prebuffer|前置緩衝
precision|精確度
predefine|預先定義
predicate|述詞
predictor|預估器
preferred|首選的
preformat|預定格式
premature|過早
presecute|起訴
presenter|簡報者
primitive|原始型態
principal|主要
print out|印出
printable|可列印
privilege|權力
procedure|程序
processes|行程
processor|處理器
programme|程式
projector|投影機
prolonged|長期的
prominent|顯眼的
promotion|推廣
propagate|傳播
propeller|螺旋槳
protected|保護的
protocoll|協定
prototype|原型
provision|條款
proximity|近接
publisher|發行人
pull from|取自
pull onto|拉到
punk rock|龐客搖滾
quadratic|四方形
qualified|經資格修飾
qualifier|限定元
quickview|快速檢視
quotation|引言
radiology|放射線科
radiosity|輻射度
randomise|隨機化
randomize|隨機
rasterize|柵格化
rationale|理由闡述
read from|讀取自
read more|了解更多
read only|唯讀
read-side|讀取周圍的
readahead|預先讀取
ready for|準備好
real time|即時
real-data|實際數據
rearrange|重新排列
recipient|收件者
recognise|辨識
recognize|辨識
recommend|推薦
recompile|重新編譯
reconnect|重新連線
reconsile|調解
recordset|資料錄集
recovered|已修復
rectangle|矩形
rectifier|矯正器
recursion|遞迴
recursive|遞迴
reduction|消除
redundant|冗餘
reentrant|重新進入
reference|參考
refuse to|拒絕
reinstall|重新安裝
relations|關係
remain in|保持於
remainder|剩餘的項目
remaining|其餘
removable|可移除的
rendition|呈現
repackage|重新包裝
replicate|複寫
reply all|全部回覆
represent|表述
republish|再版
requested|請求的
requester|請求者
requestor|請求者
resampler|重新取樣器
resizable|可變更大小的
responder|回應者
result in|導致
resultant|生成的
resulting|所產生的
resultset|結果集
resurrect|復活
retention|保持
rethought|重新考慮過的
retrieval|檢索
return to|回到
reversing|翻轉
revert to|回復成
rgb color|紅綠藍三原色
rich edit|豐富編輯
rich text|rich text 格式
right key|向右鍵
right now|立即
roll back|轉返
roll down|向下捲動
roll over|滑過
root menu|根功能表
root only|衹限 root
root user|超級使用者
rooted at|源自
rosybrown|玫瑰褐
round-off|捨去
roundworm|線蟲
royalblue|紅深藍
run level|執行層次
safeguard|防衛
samaritan|撒瑪麗亞文
same name|同名
same rank|同級
sansserif|無襯線
sardinian|薩丁尼亞語
satellite|衛星
saw tooth|鋸齒
saying no|回答否
scaleable|可調比例
scan line|掃描線
scenenote|場景節點
scheduled|已排程
scheduler|排程程式
schilling|先令
scientist|科學家
scrambled|雜亂的
screenful|全螢幕
screening|篩檢
scripting|指令稿處理
scriptlet|指令單
scroll in|捲入
scroll up|向上捲動
scrollbar|捲動軸
scrolling|捲動
scrubbing|播放選位
secondary|次項
select up|向上選取
selection|選擇
selective|選擇性質
self-join|自我聯結
self-test|自我測試
semaphore|號誌
semicolon|分號
semilight|半細體字
semimetal|半金屬
send back|寄回
senseless|無意義
sensitive|敏感的
separator|分隔符號
september|九月
sequencer|音序器
serialize|序列化
serration|鋸齒狀
severable|可分割的
shall not|不應該
shareware|共享軟體
sharpness|銳利度
shielding|屏蔽
shift-out|移出
shortened|短版
shortener|縮短器
shorthand|簡短寫法
shortname|簡稱
show only|衹顯示
show tree|顯示目錄樹
showtunes|舞臺劇原創流行
shrinkage|收縮
shut down|關機
sidepanel|側邊欄
signature|簽名
signed up|已報名
sincerely|敬上
singapore|新加坡
singleton|單體
sinhalese|錫蘭語
sinophone|漢語風
site-wide|全站
situation|情況
sixteenth|第十六
slapstick|鬧劇
slateblue|青藍
slategray|青灰
sleepless|睡不着
slideshow|投影秀
slovakian|斯洛伐克語
slovenian|斯洛維尼亞語
slow down|拖慢
slow rock|慢搖滾
smartcard|靈巧卡
socialist|社會主義
soldering|焊接
solicited|懇求的
something|有些東西
sometimes|有時
somewhere|某處
southern"|南方
space bar|空白鍵
specifier|說明符
spectator|觀眾
splitting|分裂
sri lanka|斯里蘭卡
stability|穩定性
start-tag|起始標籤
startmenu|開始選單
startover|起始
starts up|起動
stateless|無狀態的
statement|敘述
statistic|統計
statusbar|狀態列
statutory|法定
stay away|保持距離
steelblue|鋼青
step down|下臺
step into|逐步執行
step over|逐程序執行
step size|步增值
stiffness|強度
stimulate|引發
stopwatch|碼錶
streaming|資料流
stretched|擴展的
strikeout|刪除線
structure|結構
stylistic|文體的
sub-to-do|子待辦
subclause|小節
subdevice|子裝置
subdivide|細分
subdomain|子網域
subfolder|子資料夾
submitter|提交者
subobject|子物件
subreport|子報告
subscribe|訂閱
subscript|註標
subselect|細部選取
substring|子字串
subsystem|子系統
subwidget|子視窗元件
successor|後繼符
sultanate|蘇丹國
summarize|概括
sundanese|巽他語
superiors|上級
supersede|取代
supertype|超級類型
superuser|系統管理者
suspected|疑似
swaziland|史瓦濟蘭
switch on|打開
switch to|切換至
switching|交換
syllabary|音節文字
syllables|音節符號
symbiotic|共生
symmetric|對稱
synthetic|人造
tab order|跳格順序
tab width|跳格寬度
table-row|表格列
tablet pc|平板電腦
tabulator|排表機
take care|注意看
take over|接手
tamazight|塔馬塞特語
tampering|竄改
tanzanian|坦尚尼亞
task list|工作列表
tasteless|無味
technical|技術
technique|技術
telegraph|電報
telephone|電話
telephony|電話學
temporary|暫時的
tentative|試行
tenths of|十分之一
terabytes|兆位元組
terminate|終止
territory|領地
test only|純屬測試
test page|測試頁
text area|文字區
text body|內文
text file|文字檔
text flow|文字排整
text wrap|換列
text-only|僅文字
thanks to|感謝
that were|受
the board|機板
the cause|原因
the colon|冒號
the first|第一個
the train|火車
there are|有些
there was|出現了
therefore|因而
thesaurus|同義詞詞典
thickness|粗細
this help|這份說明
this mail|這封郵件
this text|這段文字
this time|這次
this week|本週
this will|這將
this year|今年
threshold|臨界值
thumbnail|縮圖
time left|剩餘時間
timed out|已逾時
timescope|時間波譜
timestamp|時間戳記
title bar|標題列
to cancel|以取消
to create|以建立
to enable|以啟用
to handle|處理
to search|以搜尋
to select|以選取
tok pisin|托比辛語
tolerance|容忍度
too close|太靠近
toolchain|工具鏈
top level|頂層
top right|右上
top-float|頂流體
top-level|頂層
traceback|追溯
trackback|援引
trade off|換掉
trademark|商標
tradition|傳統
transform|變換
transient|暫時性
translate|翻譯
transport|傳輸
transpose|調換
trapezium|頂方括號
trappable|可截獲的
trash bin|垃圾桶
trash can|回收筒
traversal|遍歷
tray icon|系統匣圖示
treatment|處理
treble up|加強高音
tree view|樹狀結構檢視
trembling|抖動
tributary|支流
try again|再試一次
trying to|嘗試
tsimshian|欽西安語
turquoise|藍玉色
twentieth|第二十
two-digit|兩位數
type cast|類型轉換
type code|型態程式碼
type here|在這裡鍵入
typeahead|提前輸入
typematic|按鍵的
typically|典型狀態下
ukrainian|烏克蘭語
ultrabold|超粗體字
unable to|無法
unarchive|取消封存
unbinding|釋放繫結
unblocked|非阻斷
unbundled|非附帶的
unchanged|未變更
uncomment|取消註解
undecided|未定
underflow|下限溢位
underline|底線
unencrypt|解密
unfocused|未聚焦
unformatt|未格式化
unhandled|未經處理的
uninstall|解除安裝
unit test|單元測試
universal|泛用
unlimited|無限制的
unmatched|不符合的
unmetered|不計量的
unordered|無序
unplugged|未插入
unprotect|取消保護
unpunched|無孔的
untrusted|不可信的
up folder|上層資料夾
up to you|操之在您
up-stream|上行串流
updatable|可更新
uppercase|大寫
uruguayan|烏拉圭
usability|可用性
used file|使用過檔案
user code|使用者代碼
user part|使用者部
user-data|使用者資料
utterance|言論
valencian|瓦倫西亞語
variation|變異
venezuela|委內瑞拉
verbosity|詳細度
veriables|變數
versatile|多功能
version 2|第二版
version 3|第三版
versioned|標上版本的
vertebrae|脊椎
viability|可用性
vibration|振動
video out|視訊輸出
video-off|視訊關閉
view show|檢視放映
violation|違規
virtually|實質上
visualize|視覺化
volume up|提高音量
volunteer|志願者
wallpaper|桌布
watch out|當心
watermark|水印
webserver|網頁伺服器
wednesday|週三
well done|做得不錯
what this|這是什麼
when will|何時
whitelist|白名單
wholesale|批發式
wikipedia|維基百科
will also|也將
will fail|將無法運作
will make|將使得
wipe left|往左撥去
wireframe|線框
with euro|附歐元符號
with only|衹附
with that|具備該
withdrawn|撤回了
word only|完整的字詞
word size|字詞長度
work area|工作區
work with|適用於
workgroup|工作群組
worksheet|工作表
workspace|工作區
world map|世界地圖
worldwide|全球性
write out|寫出
writeable|可寫入
x-y chart|散點圖
x-y graph|散點圖
years old|歲
yesterday|昨天
zone name|區域名稱
zoomed-in|放大
"landscape|橫印
"statement|結算單
"to unlock|如果要解鎖
, and then|，然後
-failed to|時失敗
-have been|已被
1 hour ago|一小時之前
a cappella|無伴奏合唱曲
a range of|一系列的
abbreviate|縮寫
aboriginal|原始
absorption|吸收
accelerate|加速
acceptable|可接受的
acceptance|接受
access key|快捷鍵
access log|存取記錄
accessible|可存取
accomplish|辦到
accounting|核算
accumulate|累積
accurately|準確地
activation|開通
adaptation|調適
add a path|加上路徑
add server|增加伺服器
add-remove|增加移除
additional|額外
address-of|取址
addressing|定址
adjustment|調整
administer|管理
affordance|示能性
after that|在那之後
afterwards|在此之後
aggressive|強烈
aging time|存留時間
alchemical|鍊金術
alias name|別名
align left|靠左對齊
all-in-one|一體
allegation|申述
allocation|配額
along with|隨附於
alphabetic|字母順序
altogether|全體
ambivalent|矛盾
ammunition|軍火
an earlier|較早的
anesthesia|麻醉
annotation|附註
antarctica|南極洲
anti alias|美化字型
anti-alias|消除鋸齒
anti-theft|防竊
antistatic|抗靜電
apart from|除了之外
apostrophe|單引號
apparently|顯然
appearance|外觀
appears to|似乎
append log|附加記錄
applicable|適用的
applicator|應用物
aquamarine|青綠
arbitrator|仲裁人
arctangent|反正切
arithmetic|算術
arrow-wave|波浪箭頭
arrowheads|箭頭
artwork by|繪圖者
as long as|衹要
as much as|就像
as opposed|抑或
as soon as|一旦
as well as|以及
as you can|儘可能
asian font|亞洲語言字型
assignment|指派
assistance|協助
associated|關聯的
assumption|假定
asymmetric|非對稱
at present|目前
at startup|啟動時
at the top|位於頂端
athapascan|史拉維語
attachment|附件
attempt to|試圖
attractive|吸引人的
audio card|音效卡
audio file|音效檔
audio type|音訊型式
australian|澳大利亞英語
autofilter|自動篩選
autoformat|自動格式
autoindent|自動縮排
autoloader|自動載入程式
automation|自動作業
autoscroll|自動捲動
autoswitch|自動切換
autoupdate|自動更新
avantgarde|前衛音樂
azerbaijan|亞塞拜然
background|背景
backing up|備份
bad length|長度不當
bangladesh|孟加拉
base class|基礎類別
base point|基點
basic type|基本型式
batch file|批次檔
batch-mode|批次模式
be able to|能夠
be already|已經
be careful|小心
be correct|正確
be corrent|正確
be damaged|受損
be enabled|已啟用
be full of|充滿了
be handled|被處理
be invalid|無效
be just an|僅僅是一個
be missing|缺少
be open to|易引起
be outside|超出
be patient|耐心等候
be present|都到位
be running|偵測到
"be sure to|請記得
be sure to|記得
be this ok|確定這樣嗎
be unknown|不明
because of|因為
beforehand|事先
begin with|以開始
belarusian|白羅斯語
bermingham|伯明罕
besides of|除了
big endian|高位在前
big thanks|非常感謝
biological|生物學的
birth year|出生年分
black font|黑粗字型
blank disc|空白光碟
blind copy|密件副本
block size|區段大小
block-line|塊狀線
blockchain|區塊鏈
blockquote|縮排文字
blood type|血型
blueviolet|藍紫
board size|棋盤大小
bolivarian|玻利瓦爾
boot block|啟動區段
bootloader|開機載入程式
booty bass|亢奮低音
both sides|兩側
bottleneck|瓶頸
breadcrumb|麵包屑
breakpoint|中斷點
brightness|亮度
broken bar|間斷線
brownstone|磚石
build mode|建立模式
by default|按照預設
by service|依服務
by subject|依主題
byte order|位元組次序
calculator|計算器
candidates|侯選者
cap height|大寫字母高度
capability|能力
cape verde|維德角
capitalize|字首字母大寫
caret mode|鍵盤瀏覽模式
case match|大小寫
case study|案例研究
cd/dvd-rom|光碟
centimeter|公分
centralize|置中
change bar|變更列
changeback|切回
chargeback|費用計算
chartreuse|淡黃綠
check mark|勾選標記
checkpoint|查核點
child type|子代型態
chroma key|色幕去背
chunk type|塊類型
ciphertext|密文
circle out|圓形放射
circumflex|抑揚符號
circumvent|規避
city state|城市國
class body|類別本體
clear text|明文
clock face|鐘面
clock tick|時鐘周期
club-house|俱樂部室
clutterbar|酷特列
co-branded|聯名
code point|碼點
code table|碼表
coerced to|強制變更成
coincident|相符的
cold calls|電話推銷
collection|群集
collimator|瞄準儀
color code|色碼
color ramp|顏色漸層
color-rich|顏色鮮艷
column-set|欄集合
comes with|隨附
commandset|命令集
commercial|商業
commission|委任
commitment|承諾
comparator|比較器
comparison|比較
compatible|相容
compelling|強制的
complement|補數
completely|完全
completion|補完
compliance|規範遵循
compressed|壓縮過的
compressor|壓縮器
compromise|折衷
compulsory|強制性質的
computable|可計算的
conceptual|概念
conclusion|結論
concurrent|並行
condensing|濃縮
conference|會議
configured|已組配
conform to|合乎
congestion|壅塞
congruence|全等
connect to|連線到
consistent|一致的
consortium|社團
constantly|經常
constitute|構成
constraint|條件約束
contact us|聯絡我們
contention|競爭狀態
contextual|語境的
continuity|持續性
continuous|連續的
contribute|貢獻
controller|控制器
convention|慣例
conversion|轉換
coordinate|座標
copy count|副本份數
correction|校正
correlator|關連符
correspond|相應
corrigenda|勘誤表
costa rica|哥斯大黎加
could help|可能會有幫助
covariance|協方差
create new|建立新的
created by|創作者
credential|憑據
cross-fade|交錯淡變
cuban peso|古巴披索
cumbersome|麻煩的
cumulative|累計
cyberspace|數碼空間
dance hall|舞廳
dark green|深綠
darkorange|深橙
darkorchid|深蘭花紫
darksalmon|深橙紅
darkviolet|深藍紫
data cache|資料快取記憶體
data frame|資料框
data store|資料存放區
data table|資料表
data-bound|資料繫結
day number|日號
deactivate|停擺
dead store|無作用儲存體
deallocate|取消配置
deblocking|解塊
decelerate|減速
declarator|宣告子
decompress|解壓縮
decoration|裝飾
decorative|美觀型
dedication|獻辭
deductible|扣除額
defamatory|中傷
deficiency|缺失
defined as|定義為
definitely|肯定地
definition|定義
deflection|偏轉
defragment|磁碟重組
degenerate|退化
delimiting|界定
democratic|民主
dendrogram|樹狀圖
denotation|標誌
department|部門
dependency|依存性質
depends on|依存於
deployment|部署
derivative|衍生的
descendant|子代
descendent|下降
descending|遞降
descriptor|描述元
designator|指明項
destructor|解構子
devanagari|梵文字母天城體
devoted to|致力於
diagnostic|診斷
dialog box|對話框
dictionary|字典
difference|差別
difficulty|難度
dirlistbox|目錄列表框
disapprove|不同意
discipline|規律
disclaimer|免責聲明
disclosure|洩漏
disconnect|中斷連線
discourage|不鼓勵
discretion|授意
disk space|磁碟空間
dispatcher|派送程式
distribute|散佈
divergence|發散
do nothing|沒做任何事
dodgerblue|寶藍
dot matrix|點陣
downsample|降低取樣
downstream|下游
drag right|向右拖曳
drill down|鑽探
dropshadow|陰影
dull green|沌綠
duodecimal|十二進制
duplicated|重複的
duplicator|複製機
durability|持久性
dutch part|荷屬
duty cycle|工作周期
e-business|電子商務
each other|彼此
easter egg|復活節彩蛋
easyupdate|易用更新
eighteenth|第十八
either way|任一方式
elasticity|彈性
electronic|電子
eliminates|結束
elliptical|橢圓的
empty file|空檔案
empty page|空白頁面
enable all|全部啟用
end-marker|終端符號
end-to-end|端對端
endianness|尾序
enrollment|入學
enter here|在這裡輸入
enterprise|企業
enumerator|枚舉值
equal sign|等號
equatorial|赤道
error code|錯誤碼
error file|錯誤檔案
error rate|錯誤率
escapement|逸出
estimation|評價
estrangelo|福音體
euro-house|歐式屋室
evaluating|求值
evaluation|求值
even field|偶數欄位
even pages|偶數頁
even width|對等寬度
event-info|事件資訊
eventually|終於
every time|每次
everything|所有東西
everywhere|到處
executable|可執行檔案
expand all|全部伸展
expandable|可伸展的
experience|經驗
experiment|實驗
expiration|逾期
expression|運算式
extraneous|外來
eyedropper|取色
fahrenheit|華氏
fax number|傳真號碼
few people|很少人
figure out|算出
file table|檔案表
filesystem|檔案系統
fill color|充填顏色
fill style|填入樣式
filled out|已填寫
filter out|篩選出
final line|最終列
first line|首列
first name|名字
first page|第一頁
first part|第一部分
first step|第一步
first time|第一次
fixed font|定寬字型
flash disk|閃碟
flex hints|屈曲修飾
flood fill|填滿
follow the|依循
foreground|前景
form-level|表單層次
formatting|格式化
forwarding|轉送
foundation|基金會
fourteenth|第十四
fractional|部分的
frame menu|框架功能表
frame rate|影格率
frame-type|影格類型
fraudulent|欺詐
free block|可用區塊
free space|剩餘空間
free trial|免費試用
from right|從右側
front left|左前方
front page|序頁
front view|正面圖
full color|全彩
full power|完全供電
full speed|全速
full stack|全端
full width|全寬
full-frame|完整畫面
full-width|全形
fullscreen|全螢幕
functional|功能正常
generation|生成
generative|生成式
genericity|泛型
generosity|慷慨
german std|德制標準
ghostwhite|蒼白
gid number|GID 號碼
gilbertese|吉伯特語
git config|git config
glagolitic|格拉哥里字母
go back to|回到
go forward|前進
go through|走過一遍
go to line|前往指定列
goes great|相處融洽
going down|進行關機
government|政府
gracefully|平順
graduation|畢業
graininess|紋路
gray scale|灰階
great work|輝煌的成果
grey level|灰階
grid lines|網格線
grid point|網格點
gtk+ based|基於 GTK+ 的
gtk-cancel|取消
gtk-remove|移除
guadeloupe|瓜地洛普
guide line|參考線
guillotine|裁紙機
hairstyler|髮型
handedness|手工
handle the|處理
happy with|滿意
hard drive|硬碟
hard error|硬性誤差
hard limit|強制限制
hard-coded|固編的
harmonious|協調的
hash table|雜湊表
healthcare|醫療
heart rate|心跳速率
hieroglyph|象形文字
high level|高階
hiligaynon|希利蓋農語
historical|之前
homophonic|諧音
homothetic|相似
honour the|考量到
horizontal|水平
hypergrove|超樹叢
hypermedia|超媒體
i am sorry|抱歉
identifier|識別碼
ideographs|表意文字
if desired|需要時
ill-formed|不當形式的
illuminate|照亮
illustrate|展示
im account|即時傳訊賬號
image base|映像基底
image file|圖像檔案
image type|圖像類型
implicitly|隱含地
importance|重要性
important"|重要
impossible|不可能的
impression|印刷
in %d hour|於 %d 小時後
in %i hour|於 %i 小時後
in any way|以任何方式
in case of|如有
in line %d|於第 %d 列
in minutes|以分鐘為單位
in seconds|的秒數
in service|服務中
in summary|在概要中
in tooltip|在提示框中
in-process|同行程
inactivity|不作用
inari sami|伊納里薩米語
incidental|附帶的
incomplete|不完整
incorrect"|不正確
indefinite|無限期
indication|指示
indigenous|原住民
individual|個別
indonesian|印尼語
industrial|工業音樂
infections|感染數
inflection|彎折
inhibiting|禁止
initialize|初始化
initiation|初始化
innerstyle|內部樣式
innovation|創新
inordinary|不尋常
input area|輸入區
installed"|已安裝
installing|安裝
instead of|以代替
instrument|器具
integrator|積分器
intergrate|整合
interleave|交錯
intraframe|幅內
invalidate|設為無效
investment|投資
invitation|邀請
invocation|調用
irrelevant|無關的
isocontour|輪廓面
isomorphic|同構
it appears|看來
it depends|不一定
it is thus|因此會
iterations|反覆運算
jam-packed|塞滿
jamahiriya|群眾國
job number|工作編號
join group|參與群組
jump table|跳躍式表格
kazakhstan|哈薩克
keep above|保持在上層
keep below|保持在下層
keep-alive|持續作用
key frames|關鍵影格
key phrase|關鍵詞
keybinding|按鍵繫結
kharoshthi|佉盧文
kinematics|動力學
korean won|韓國圓
korn shell|Korn shell
kyrgyzstan|吉爾吉斯
laptop lid|筆電上蓋
large size|大型
last month|前一月
last visit|上次登入
laterality|側向性
lead magic|導語魔術字元
learn more|了解更多
left align|靠左對齊
left blank|留白
left click|按一下左鍵
lefty-mode|左手模式
legibility|易讀性
legitimacy|合法性
legitimate|合法
letterlike|類字母
liable for|負責
light blue|淺藍色
light cyan|淺藍綠色
light gray|淺灰色
light grey|淺灰色
light pink|淺粉紅
light rain|小雨
lightcoral|淺珊瑚紅
lightgreen|淺綠
like above|如上
limitation|限制
line break|分列符號
line graph|折線圖
line scope|線型
line space|列空間
link count|鏈結記數
linux only|衹限於 Linux
lithuanian|立陶宛語
live image|自活映像檔
live media|自活媒體
load order|載入順序
local file|本機檔案
local host|本機
local port|本機通訊埠
located at|位於
log viewer|記錄檢視器
log you in|將您登入
logging in|登入中
look ahead|期望
look-ahead|預估
looks like|看來像是
low german|低地德語
lower case|小寫
lower than|低於
luba-lulua|盧巴－盧拉語
luminosity|光度
luxembourg|盧森堡
macedonian|馬其頓語
macroblock|巨集區塊
macropixel|巨像素
madagascar|馬達加斯加
mail merge|合併列印
main table|主表格
maintained|所維護的
maintainer|維護者
make sense|具任何意義
management|管理
manichaean|摩尼教徒
manipulate|操控
many times|多次
mapudungun|阿勞坎語
marginalia|旁註
marshaling|封送處理
martinique|馬丁尼克
mask layer|圖層遮色片
master key|主控金鑰
matches in|項目符合者於
mauritania|茅利塔尼亞
may not be|可能不
meaningful|有意義的
meditation|沉思
meditative|冥想音樂
mediumblue|暗藍
membership|會員資格
memberwise|成員逐一
memorandum|備忘錄
menu label|功能表標貼
message-id|訊息識別號
metadevice|中繼裝置
micronesia|密克羅尼西亞
microphone|嘜筒
middle dot|中點號
middleware|中介軟體
millennium|千禧年
millimeter|公釐
minus sign|減號
misleading|誤導
misspelled|拼錯的
moderation|調控
modern-day|現代的
moistening|潤濕
monetarily|付費
monitoring|監看
monochrome|單色
monoscopic|平面影像
montenegro|蒙特內哥羅
montserrat|蒙塞拉特島
more times|更多次
most often|最常
mountpoint|掛載點
mousewheel|滑鼠滾輪
move right|向右移動
mozambique|莫三比克
multi-code|多重程式碼
multi-line|多列
multi-part|多重組成
multi-sync|多重同步
multiframe|多重影格
multihomed|多連接
multilines|多列
multimedia|多媒體
multiplexr|多工器
multiplier|倍數
multipoint|多點
multitouch|多點觸控
multitrack|多軌
must first|首先必須
nakhi geba|納西格巴文
name group|名稱群
name space|名稱空間
named file|已命名的檔案
named pipe|具名管線
namestripe|名條
narrowband|窄頻
navigation|導覽
neapolitan|拿坡里語
needed for|所需自
negativity|負性
negligence|疏忽
negligible|無用的
net number|網路編號
new search|重新搜尋
new window|開新視窗
new zhuyin|新注音
next frame|下一影格
next month|次月
next track|下一曲目
nice value|優先值
nineteenth|第十九
no contact|無接觸
no matches|沒有符合者
no rule to|沒有規則可
non-causal|非因果
non-client|非客戶端
non-profit|非營利的
non-string|非字串
non-visual|隱藏式
none found|沒有資料
not at all|完全不會
not enough|不足
not in use|不在使用中
not listed|未列出
nothing to|沒有任何東西可
noticeable|值得注意的
novel idea|新奇的點子
nowhere to|無處可
numberical|數值
numeration|記數法
occasional|臨時
occupation|職業
occurrence|出現
odd parity|奇同位
old italic|古義大利文
old permic|古彼爾姆諸文
old turkic|古突厥語
on and off|開關
on line %d|於第 %d 列
on request|請求時
on the fly|即時
on the map|地圖上
once a day|一天一次
once again|再一次
one second|一秒鐘
operate on|作用於
operations|計算
optimistic|開放式
option bar|選項列
optionally|可選擇地
originally|原本地
originated|發起的
originator|發起者
orthogonal|正交的
other than|不同於
outerstyle|外部樣式
outpatient|門診病患
output log|輸出記錄
over-write|覆寫
overcharge|超賣
overriding|強迫
overstrike|疊印
owner name|所有者名稱
padding on|開啟填補
page break|分頁符
page count|頁數
page fault|分頁錯誤
page frame|頁框
page order|頁序
page-model|頁式樣
pageholder|長駐頁面
pagination|編頁
palm pilot|Palm Pilot
pan window|全景視窗
pangasinan|龐加辛南語
papayawhip|粉木瓜橙
paper tray|送紙匣
papiamento|巴皮亞曼多語
papiamentu|帕皮阿門托語
paraplegic|半身麻痺患者
parity bit|同位元
particular|特定
partitions|分割區
pass count|循環計數
passphrase|密語
percentage|百分比
percentile|百分比
perceptual|感知
perforated|穿孔的
perforator|打洞器
performing|履行
peripheral|周邊
periwinkle|藍紫
permission|許可
persistent|長久的
philosophy|哲學
phoenician|腓尼基語
photograph|相片
pick it up|取出它
pictograph|圖案
pipelining|管線操作
plain text|純文字
plan ahead|事前計畫
play again|執行巨集
player one|玩家一
player two|玩家二
point size|像點大小
polsk punk|波蘭龐克
polybezier|多點曲線
polymarker|多點標記
popularity|普遍
population|人口
popup menu|快顯功能表
portbrazil|巴西葡萄牙語
portmapper|通訊埠映射器
portuguese|葡萄牙
positioned|已定位
post-build|組建後
postfilter|後濾波器
postmortem|檢討
pound sign|英磅符號
powderblue|淺灰藍
powered by|動力搭載
pragmatics|實際學
pre-loaded|預先載入
precaution|預防措施
precedence|優先權
prediction|預估
preference|偏好
prepayment|預付
preprocess|前置處理
presetting|預置
presumably|據推測
previously|之前
print this|印出這份
priorities|優先等級
privileged|需要權力的
production|生產
programmer|程式員
projection|投影
promulgate|頒佈
proportion|比例
protractor|分度計
proxy host|代理主機
pseudocode|假擬程式碼
public key|公開金鑰
punctuator|標點符號
put option|認售期權
quaternion|四元數
queued fax|外送傳真
quiet mode|無訊息模式
quillotine|裁紙機
raid level|RAID 層
rajasthani|拉賈斯坦語
rarotongan|拉羅通加語
rasterizer|柵格化程式
raw vector|純量向量
reactivate|重新活化
read about|了解如何
read-ahead|預先讀取的
read-write|可讀可寫
real-world|真實
reasonable|合理的
reassemble|重新組合
reassembly|重新組合
receiptant|收信人
reciprocal|倒數
recognized|辨識的
recognizer|辨識器
redirected|已重新導向
redundancy|冗餘
reentrancy|重行進入
referenced|引用
refinement|重整化
reflection|映像
refundable|可退還的
regenerate|重新產生
registered|已註冊的
regression|迴歸
regulating|調整
regulation|規則
relational|關聯式
relaxation|鬆弛
relinquish|放棄
relocation|重定址
remaining"|剩餘
remove all|全部移除
rendezvous|會合
repaginate|重新製作格式
repertoire|庫
repetition|重複
reply with|回信依照
reposition|重新定位
repository|儲存庫
reproducer|再製器
reputation|名聲
requires a|需要
reschedule|重新排程
reset time|重設時間
resilience|抗彈性
resistance|阻力
resolution|解析度
respectful|表示敬意
respective|各自的
responsive|回應型
restaurant|餐廳
result set|結果集
results in|結果於
return key|換列鍵
revocation|撤銷
ridiculous|荒謬
right back|馬上回來
right side|右側
robustness|強健性
rongorongo|朗格朗格象形文字
round down|捨去
round-down|捨位
round-trip|往返
roundabout|替代道路
rubberband|橡皮筋
run-length|運行長度
salutation|信函開頭稱呼
salvageval|可用年限結束後的價值
same place|相同位置
samplerate|取樣率
san marino|聖馬利諾
sandybrown|黃褐
sans serif|無襯線
saturation|飽和度
saurashtra|索拉什特拉文
save space|節省空間
scientific|科學
scissoring|剪裁
scratchpad|塗鴉
screencast|畫面場景
screenshot|螢幕快照
screentips|工具提示
scriptable|可編寫指令稿的
scroll bar|捲動軸
scrollback|向後捲動
search for|搜尋
search key|搜尋關鍵字
searchable|可搜尋的
secret key|密鑰
secularism|世俗主義
segmenting|分段
select all|全選
selectable|可選取的
self built|自建
separation|分隔
sequencing|定序
sequential|循序的
serializer|串化器
serpentine|彎曲的
session id|期間識別碼
setting up|設定
seychelles|塞席爾
sharp join|銳角聯結
sharpening|清晰化
shimmering|閃爍的
short name|簡稱
short term|短期
shortcodes|短碼
should not|不應該
show again|再次顯示
silhouette|剪影
similar to|類似於
simulation|模擬
singhalese|錫蘭語
single-hit|單擊
sinusoidal|正弦
siteaccess|網址存取權力
skolt sami|斯克特薩米語
slide show|投影片放映
small caps|小字
small size|小型
smartphone|手機
smoothness|平滑度
soft reset|軟式重設
solid line|實線
some minor|些許
some space|一些空間
sort order|排列順序
sound card|音效卡
sound clip|音效剪輯片段
soundtrack|原聲帶
spare time|空閒時間
specialize|專用化
spellcheck|拼寫檢查
spot color|特別色
spot light|聚光燈
spots left|剩餘名額
stagnation|停滯
standalone|獨立式
start menu|開始功能表
start mode|啟動模式
start over|起始
start page|起始網頁
start time|起始時間
start-stop|起停
staticizer|靜態產生器
stationery|信箋
status bar|狀態列
steel-gray|鐵灰色
stellation|放射狀
storyboard|分鏡圖
straighten|打直
streamline|串流線
strictness|嚴格
stylesheet|樣式表
sub volume|副音量
subaccount|子賬號
subaddress|子位址
subclasser|子分類程式
subcommand|子命令
subelement|子元件
subformula|子公式
submission|提交
subnetwork|子網路
subpackage|子套件
subprocess|子行程
subprofile|子規範檔
subprogram|子程式
subroutine|副常式
subscriber|用戶
subsection|小節
subsequent|後續
subsidiary|輔助
substitute|替代
subsubname|子名稱的子名稱
subtracter|減法器
subtrahend|減數
successful|成功
sufficient|充分的
super type|超型式
super user|超級使用者
superblock|超區塊
superclass|超級類別
supervisor|監督人
supplement|補充
surrealism|超現實主義
surrogates|代理區
swap space|交換空間
swipe left|向左滑動
switch off|關掉
switchpath|交換路徑
symbol set|符號集
synchronic|共時
system log|系統日誌
systemtray|系統匣
table body|表格本體
tabulation|跳格
tachometer|轉速計
tajikistan|塔吉克
take place|發生
take up to|花到
taken from|取自
tar header|打包標頭
technician|技術人員
technology|技術
teleporter|傳送器
television|電視
temptation|誘惑
terminator|終止符號
text frame|文字框
thanks for|感謝
the answer|答案
the medium|媒體
the screen|畫面
the second|第二
thermistor|熱電阻
thirteenth|第十三
this could|這可能會
this email|這封電子郵件
this is ok|這沒問題
this means|這表示
this month|本月
thoughtful|考慮周到的
throttling|節流
throughout|全
throughput|流量
tidying up|收拾
time frame|時間區段
time lapse|曠時攝影
time-saver|時間儲存程式
timekeeper|計時者
timeliness|時效性
timing-out|逾時
to contact|聯絡
to default|為預設
to display|以顯示
to do list|待辦列表
to or from|成為或來自
to perform|以進行
to provide|以提供
to replace|以置換
to use for|以用於
token ring|字組環網路
tongue-out|吐舌
too old to|太舊而無法
took place|已發生
top margin|上邊界
top trends|熱門趨勢
total time|總時間
trace code|追蹤程式碼
track name|曲目名稱
transcribe|抄寫
transcript|轉錄
transducer|探頭器
transistor|電晶體
transition|轉換
transitive|過渡
translator|翻譯者
transverse|橫切面
trash file|清除檔案
treated as|視為
trespasser|侵入者
true color|全彩
truncation|截斷
tunnelling|穿隧
turn it on|開啟它
turnaround|周轉
turned off|被關閉
two-factor|雙因子
typewriter|打字機
typography|排版式樣
ultralight|超細體
ultrasonic|超音波
unasserted|未主張的
unassigned|未指派的
unattended|無人值守的
unblocking|解除阻斷
uncompress|解壓縮
undeclared|未宣告
underlined|加底線
underlying|下層的
underneath|於之下
underscore|底線
understand|了解
unexpected|未預期的
unfamiliar|不熟悉的
unformated|未格式化的
ungraceful|不平順的
union type|聯集型態
uniqueness|惟一性
university|大學
unmodified|未更動
unnumbered|未編號的
unofficial|非正式
unpackaged|未加入套件的
unreadable|不可讀取
unregister|移除註冊
unresolved|無法解析的
unsendable|無法發送
untrashing|救回
up to date|到最新版
upper case|大寫
upper left|左上
upsampling|上取樣
usable for|可用於
used space|使用空間
user agent|使用者代理
user guide|使用者指南
user level|使用者級
uzbekistan|烏兹別克
valid from|有效自
validation|驗證
value type|數值類型
value-list|值列表
vermillion|朱紅
versioning|定版
very first|首次
vietnamese|越南語
virtual cd|虛擬光碟
virtualize|虛擬化
visibility|可視性
voice-over|旁白
voiceprint|聲紋
volume set|卷冊集
wait until|等到
webcasting|網路廣播
welcome to|歡迎使用
well known|廣為人知
what to do|要做什麼
whether to|是否要
whiteboard|電子白板
whitepaper|白皮書
whitesmoke|白霧色
whitespace|空白
whole text|整篇文字
widescreen|寬螢幕
widget set|視窗元件集
windows me|視窗 ME
wipe right|往右撥去
word count|計算單字數目
work phone|公務電話
workaround|變通方法
world wide|全世界
would like|想要
wrap lines|自動換列
write down|寫下
write head|寫頭
write only|唯寫
written by|作者
written to|寫入
wu chinese|漢語吳語
yes to all|全部皆是
your names|漢語官話翻譯小組
your saved|您所儲存的
yugoslavia|南斯拉夫
zoomed-out|縮小
"be careful|請小心
-be not -en|還沒有
-failure to|時失敗
4.1-channel|4.1 聲道
5.0-channel|5.0 聲道
5.1-channel|5.1 聲道
7.1-channel|7.1 聲道
8 bit clean|不含第八位元
a couple of|幾個
a few hours|幾小時
a number of|一堆
abstraction|抽象
accelerator|加速功能
access code|存取碼
accommodate|遷就
accordingly|根據不同的情況
accumulator|累加器
acknowledge|認可
acquisition|獲取
action-info|動作資訊
adapted for|為打造
add project|新增專案
addressbook|通訊錄
advancement|進展
advise loop|建議名單
affiliation|會籍
afghanistan|阿富汗
aggregation|聚合
alarm clock|警示鐘
align right|靠右對齊
all aspects|全方位
all matches|所有符合者
all the way|一路
alpha level|透明階層
alpha value|透明度
already -en|已
alternating|交互的
alternative|替代方案
among which|其中
and did not|而未
anniversary|周年紀念
another one|另外一個
antibiotics|抗生素
apparatuses|器械
application|應用程式
appointment|約會
appreciated|感謝
approaching|逼近
appropriate|適宜
approximate|近似
arbitration|仲裁
arcade game|街機
arrangement|編排
as a result|結果造成
as early as|早在
as found in|如所示
as intended|如預期地
as possible|儘可能地
association|關聯
at a glance|看一眼
at any time|隨時
at the back|位於後方
attack time|起音時間
attenuation|衰減
attribution|歸屬
audio input|音效輸入
audiovisual|視聽
audit trail|稽核存底
auto-detect|自動偵測
auto-logout|自動登出
auto-select|自動選取
autocontour|自動輪廓
autocorrect|自動校正
automatical|自動
automounter|自動掛載程式
autooutline|自動顯示大綱
autorefresh|自動重刷
autosensing|自動感應
autoupgrade|自動升級
azerbaijani|亞塞拜然語
back-enable|允許後移的
backscatter|反向散射
backup copy|備份副本
bailing out|正在擺脫
base module|基本模組
base volume|基本磁碟區
be about to|即將
be disabled|已停用
be finished|已完成
be going to|將要
be in touch|聯絡上了
be not sure|不確定
be not used|還沒使用
be probably|或許
be required|為必要項目
be the same|相同
be you sure|確定要
best-effort|盡力
bigger than|大於
binary blob|二進位包
binary tree|二元樹
birth month|出生月分
black level|黑位準
black metal|黑金屬
blackletter|花體
blacklisted|列入黑名單
blank lines|空列
block chain|區塊鏈
block-local|本機區段
bogged down|陷入困境
boilerplate|未定案
bold italic|粗斜體
bookmarkbar|書籤列
bookmarklet|書籤條
boot server|啟動伺服器
bootable cd|可開機光碟
bottom left|左下
bounce-back|反彈
box drawing|框線繪製
break apart|打散
broadcaster|播放者
broken link|中斷的鏈結
broken pipe|管線中斷
browse with|瀏覽方式
by location|依位置
by means of|依靠
by nickname|依暱稱
by the way,|順道一提，
calibration|校準
call option|認購期權
can be slow|可能會變慢
cannon bone|管骨
carbon copy|副本
card holder|卡支撐器
card number|卡號
card reader|讀卡機
cash drawer|錢箱
catastrophe|災難
categorized|分類
cd recorder|光碟燒錄機
cell header|細胞標頭
center area|中間區域
centerplane|中央機板
centimetres|公分
certificate|憑證
change case|大小寫轉換
char signed|有號字元
cheat sheet|速查表
checked out|已簽出
child pages|子頁面
chrominance|顏色類型
client area|客戶端工作區
client side|客戶端
closed loop|封閉迴路
closed path|封閉路徑
closing tag|結尾標籤
code-behind|代碼後置
coefficient|係數
collaborate|協作
color space|顏色空間
color theme|配色主題
column mode|區塊模式
column-wise|逐欄
combination|組合
comfortably|方便地
coming from|來自
coming soon|敬請期待
command box|指令方塊
command key|指令鍵
command set|命令集
comment out|註解掉
common name|一般名稱
commonality|共同性
communicate|通訊
compared to|比做
competition|比賽
compilation|編譯
complicated|複雜
compositing|複合
composition|佈局
computation|計算
concatenate|串連
concurrency|並行
conditional|條件
conductance|電導
config file|組態檔案
conformance|符合度
conjunction|接合
consecutive|順序的
consistency|一致性
consolidate|合併計算
constituent|構件
constructor|建構子
containment|內含
contains no|不含任何
contingency|偶然度
contributor|貢獻者
control bar|控制列
convergence|收斂
convertible|可兌換
convolution|疊積
cooling fan|冷卻扇
coordinator|協調者
coprocessor|輔助處理器
copywriting|文案
correct for|適用於
correlation|相關
counterfeit|仿冒品
counterpart|對等部分
cpu bracket|中央處理器支架
credit card|信用卡
credit link|銘謝鏈結
crowdsource|眾包
current map|現行映射
curved line|曲線
cybernetics|模控學
dark purple|深紫
dark yellow|深黃
darkmagenta|深洋紅
dashed line|虛線
data packet|數據封包
day of week|週中某日
death metal|死亡金屬
declaration|宣告
deepskyblue|深天藍
default:ltr|default:LTR
default:rtl|default:RTL
deformatter|形變項
degradation|劣化
degree sign|度號
deinterlace|去交錯
delete line|刪除一列
demodulator|解調器
demographic|人口統計
demultiplex|多工解碼
denominator|分母
depended on|所依存的
deprecation|揚棄
dereference|提領
description|描述
descriptive|描述性
deserialize|取消序列化
design size|設計尺寸
designation|指明
destination|目的
destruction|解構
destructive|破壞性
determinate|確定
development|開發
device tree|硬體結構樹
did not yet|尚未
dimensional|尺寸的
direct mode|直接存取模式
disable all|全部停用
disassemble|反組譯
disjunction|分離
disposition|部署
distinguish|區別
distributed|已經散佈的
distributor|散佈者
do it later|稍後才做
do not have|沒有
do the rest|完成剩下的工作
documentary|記錄
dollar sign|錢幣符號
domain name|網域名稱
dotted line|虛線
double size|兩倍大小
doubleclick|按兩下滑鼠
down-stream|下行串流
driver disk|驅動程式碟片
drop shadow|落下式陰影
drop target|置放目標
dual-ported|雙埠
duplication|複製法
dynamicizer|換態器
ease of use|簡易操作
easy-to-use|易用的
edit anyway|依然編輯
editability|可編輯性
edutainment|育樂
el salvador|薩爾瓦多
electrolyte|電解質
electronics|電子學
embarrassed|尷尬
empty lines|空列
empty value|空白值
encapsulate|封裝
enclosed in|夾於
end of file|檔案結尾
end of line|列尾
end of text|文末
end-of-line|列尾
endorsement|背書
enforceable|可實施的
enhancement|提升
enlargement|放大
ensure that|確定
enter group|編輯群組
entire list|完整的列表
entire page|整頁
entry point|進入點
enumeration|枚舉類型
environment|環境
equidistant|等距
equivalence|等價
error count|錯誤計數
error level|錯誤層級
euro-techno|歐式數位合成
evaporation|蒸發
even parity|偶同位
event group|事件群
event-ready|事件就緒
event-reply|事件回應
except that|除了說
exe project|可執行檔案專案
existential|既存
expectation|期望
expenditure|開支
explanatory|說明性
exponential|指數
extra large|特大
extra-pulse|多出之脈波
extremities|四肢
family kind|字族種類
fast-update|快速更新
fastforward|快進
fax message|傳真消息
few seconds|數秒
fiji dollar|斐濟元
filter type|濾波器型式
final angle|最終角度
fingerprint|指紋
first level|第一級
first three|前三個
fit page to|調整頁面以吻合
fixed point|定點
fixed width|固定寬度
fixed-pitch|固定字幅
floppy disk|軟碟
floralwhite|花白
fluctuation|變動
fly through|掃視
folder tree|資料夾結構
followed by|跟隨自
followup-to|跟貼
font family|字族
font weight|字型粗細
for a while|一段時間之內
for details|以了解細節
for example|舉例來說
for license|以了解授權
for version|以獲得版本
force touch|力度觸控
foreign key|外部索引鍵
forestgreen|森林綠
form factor|主機板尺寸
form layout|表單佈局
forwardonly|順向
framebuffer|影格緩衝區
francophone|法語風
free memory|剩餘記憶體
freed space|釋放的空間
french part|法屬
from now on|從現在起
front panel|前方面板
front right|右前方
ftp account|FTP 賬號
full access|任意存取
full backup|完整備份
full circle|整圓
full duplex|全雙工
full screen|全螢幕
full search|完整搜尋
full-server|全伺服程式
full-shaped|全形
furthermore|更進一步
fusion heat|熔解熱
gain-scaled|增益定標
gan chinese|漢語贛語
generalized|一般化
geolocation|地理位置
german mark|德國馬克
get down to|認真
get started|起步
get-replace|獲得置換
given angle|預設角度
glassy eyes|目光呆滯
global name|總體名稱
gone online|上線
gothic rock|哥德搖滾
grand total|總計
grandparent|祖父節點
granularity|粒度
green earth|土綠
greenlandic|格陵蘭語
greenyellow|綠黃
group scope|群範圍
group-label|群組標貼
guesstimate|預估
half of all|半數的
half-shaped|半形
half-sphere|半球體
hamiltonian|漢米爾敦函數
handshaking|交握協定
have a look|查看一下
have signed|已簽署
have size 0|大小為零
header file|標頭檔
header name|標頭名稱
header page|標頭頁
heavy metal|重金屬
heavyweight|重量級
hello world|大家好
help screen|說明畫面
hexadecimal|十六進位
hide hidden|不顯示隱藏
higher than|高於
highlighter|突顯區
home folder|個人資料夾
home screen|主畫面
homebanking|居家理財
homogeneity|同質度
homogeneous|同質的
how are you|您好嗎
hyphenation|以連字號連接
i am afraid|恐怕
icon border|圖示邊界
ideographic|表意文字
if possible|儘量
image files|影像檔
impersonate|假冒
implausibly|難以確信
implementer|實作者
implementor|實作項
implication|隱含
impressions|初步判斷
improvement|改善
in a minute|在一分鐘之內
in addition|另外
in contrast|對照來說
in favor of|支持
in function|在函式中
in greeting|在接觸通訊中
in order to|以便
in progress|正在進行
in question|所提
in spite of|儘管
in terminal|在終端機中
in the hope|是希望
in the past|過去
in the term|期間內
in this way|如此
in-reply-to|回應
inclined to|傾向於
incremental|遞增
indentation|縮排
independent|獨立
indic-hindi|印度－印地語
indic-tamil|印度－坦米爾語
indirection|間接取值
individuals|個人
infographic|資訊圖表
infomercial|試用品廣告
informatics|資訊學
information|資訊
informative|富含資訊的
inheritance|繼承性
initialized|初始化的
initializer|初始設定式
innerhilite|內部突顯
innershadow|內部陰影
inscription|題字
insensitive|不敏感的
insert into|插入
instantiate|舉例說明
institution|機構
instruction|指令
instruments|樂器
integration|整合
intelligent|智能
interaction|交互作用
interactive|互動式
intercalate|插入
interceptor|攔截器
interchange|交換
interesting|有趣的
interlingua|拉丁國際語
interlingue|國際語
interpolate|添寫
interpreter|解譯器
interrupter|干擾器
invert case|大小寫互換
investigate|調查
irish pound|愛爾蘭鎊
irrelevance|無關
irrevocable|不可撤銷的
isle of man|曼島
isochronous|等時
itemisation|分項
ivory coast|象牙海岸
jitter-free|自在
kalaallisut|格陵蘭語
kara-kalpak|卡拉－卡爾帕克語
keep aspect|維持外觀
key binding|按鍵繫結
kinyarwanda|盧安達語
larger than|大於
last branch|末項分支
last chance|最後機會
layout file|佈局檔案
left behind|延後
left handed|慣用左手的
left margin|左邊界
left-handed|左持
less likely|較不可能
letter-case|字母大小寫
level floor|平面地板
light brown|淺褐
light green|淺綠色
light white|亮白色
lightsalmon|淺橙紅
lightweight|輕量
lightyellow|淺黃
line number|列號
linked list|鏈結列表
listen-only|唯聽
little hole|小洞
local class|區域類別
local train|區間車
local-title|區域標題
localizable|可本地化
lock screen|鎖定畫面
log service|記錄服務
log you out|將您登出
logarithmic|對數
logic error|邏輯錯誤
long vector|長整數向量
longer than|長度超過
lower bound|下限
lower limit|下限
main memory|主記憶體
main window|主視窗
maintanance|維護
maintenance|維護
make a call|打電話
make a gift|送一份禮物
make a goal|達陣
make public|公佈
make use of|利用
malfunction|功能不正常
manipulator|操控器
manual feed|手動送紙
manual help|線上手冊的說明
manual page|線上手冊
manufacture|製造
many people|許多人
many thanks|十分感謝
map feature|映射功能
marshallese|馬紹爾語
marshalling|封送
mask region|遮罩工作區
master file|主控檔案
match brace|使用成對括號
maximum age|最長歷時
maxtransfer|最大轉移量
meaningless|無意義的
measurement|測量
mediastinum|縱隔
medium size|中型
medium type|媒體型式
memory area|記憶儲存區
memory bank|記憶體組
memory card|記憶卡
memory leak|記憶體流失
menu editor|功能表編輯器
menu number|選單號碼
menu option|功能表選項
merkle root|雜湊根值
message box|訊息方塊
message log|訊息記錄
metanetwork|中繼網路
metasymbols|中繼符號
microkernel|微核心
millisecond|毫秒
minangkabau|米南卡保語
minimal set|最小集合
mirror list|鏡像表
misordering|誤序
missing dot|缺少句點
miter limit|尖角限量
model group|式樣群
monitor log|監控記錄檔
monolingual|單語言
montenegrin|蒙特內哥羅語
more easily|更易於
most likely|很有可能
most recent|最近的
motherboard|主機板
mount table|掛載表
mount-point|掛載點
mouse wheel|滑鼠滾輪
move bottom|移動到底部
multi-layer|多層
multi-point|多點
multimarker|多重記號
multiplayer|多位玩家
multiple of|的倍數
multiplexer|多工器
multiplexor|多重訊號組合器
mute sounds|靜音
mutiplexing|多工
my favorite|我的最愛
named after|命名依據
narrow band|窄頻
native code|原生碼
navajowhite|印第安黃
necessarily|必要地
negotiation|協商
nested type|巢狀類型
netherlands|荷蘭
new tai lue|新傣仂文
new zealand|紐西蘭
next record|下一筆
night light|夜光
no cheating|沒有騙人
nonbreaking|不分列
nonexistent|不存在的
nonterminal|非終結語詞
normal mode|正常模式
normal size|正常大小
north korea|北韓
not able to|無法
not allowed|不允許
not applied|不適用
not between|並非介於
not enabled|未啟用
not mounted|未掛載
not present|不存在
null string|空字串
object code|物件碼
object file|物件檔
object tree|物件樹狀結構
observation|觀察
ocean liner|遠洋郵輪
octetstring|八位元組串
of the form|的形式
old persian|舊式波斯文
on occasion|有時候
on the left|左側的
once a week|一週一次
once a year|一年一次
one or more|一或多個
one-density|一密度
only affect|衹會影響
open parent|上一層
open source|開放原始碼
opening tag|開頭標籤
opportunity|機會
opposite of|相對於
option menu|選項功能表
optionality|選項性
orientation|方向
ornamentals|裝飾物
oscillating|振動
out of date|過期
out of work|失業
out-of-band|頻帶外
outerhilite|外部突顯
outershadow|外部陰影
outlet mall|暢貨中心
output port|輸出埠
outstanding|待處理
overcurrent|溢流
overlay-red|外覆－紅
overloading|多載
overwritten|覆寫
pack-reused|打包重用
packaged by|套件製作
packet mode|分封模式
page layout|頁面佈局
page number|頁碼
page offset|頁偏移
page-region|頁區域
paramarrays|參數陣列
parent pool|親代池
parent type|親代型態
parentheses|括號
parenthesis|括號
part number|零件編號
participant|參與者
participate|參與
partnership|夥伴
pass number|傳送號碼
passthrough|轉送
pau cin hau|鮑欽豪文
penetration|滲透
penultimate|倒數第二
perceivable|可察覺的
perforating|打洞
performance|效能
periodicity|周期性
permissible|可允許的
permutation|排列
persistence|持續性
personality|身分
perspective|視角
perthousand|千分率
pessimistic|封閉式
philippines|菲律賓
photo album|相簿
pixel clock|像素時脈
place-based|在地
placeholder|預留位置
please type|請輸入
please wait|請稍待
pop-up menu|快顯功能表
porn groove|情色音樂
port number|埠號
portability|可攜性
portiberian|依伯利亞葡萄牙語
portuguese"|葡萄牙語
positioning|定位
possibility|可能性
postal code|郵遞區號
pre-defined|預先定義的
precompiled|先行編譯
predictable|可預測
preferences|偏好設定
preliminary|初步
preparation|準備
preselector|設定
previewable|可預覽
primary key|主索引鍵
print error|列印發生錯誤
prioritized|優先的
private key|私鑰
probability|可能性
proficiency|能力
programming|程式設計
progressbar|進度條
progressive|漸進式
project hub|專案樞紐
proofstrain|耐應變
propagation|傳播
proprietary|專有權
provisional|暫定
pseudo-code|假擬碼
psychedelic|迷幻音樂
publication|出版品
puerto rico|波多黎各
punctuation|標點符號
push button|按鈕
quicklaunch|快速執行
quote marks|引號
radioactive|放射性質
radiobutton|單選按鈕
raise flash|引發快閃
rather than|而非
ray tracing|光線追蹤
readme file|讀我檔案
real number|實數
really wish|真的希望
recalculate|重新計算
recent list|最近使用的列表
recombining|重新合併
recommended|建議
reconfigure|重新組配
records in"|項記錄讀入
rectangular|矩形
refactoring|重構
referential|參照
regenerator|再生器
reinstalled|已重新安裝
relative to|相對於
reliability|可靠度
remember to|記得
reorganized|重新安排過的
reparenting|重排根目錄
replace all|全部置換
replaceable|可置換
replacement|置換
replication|複寫
request for|請求
requirement|需求
requires an|需要
reservation|保留
reset fonts|重設為預設字型
responsible|負責人
restoration|復原
retrofitted|回適
return code|回傳碼
rewriteable|可改寫
right align|靠右對齊
right angle|正確角度
right arrow|右箭頭鍵
right bound|右邊界
right click|按一下右鍵
right place|正確地點
right-click|右鍵點選
ring finger|無名指
rock & roll|搖滾
rotate left|向左旋轉
round robin|輪替執行
saint lucia|聖露西亞
sample rate|取樣率
sample size|樣本大小
save backup|另存備份
scalability|延展性
score board|計分板
screensaver|螢幕保護程式
script file|指令稿檔案
scroll down|向下捲動
search term|搜尋語詞
second hand|秒針
second line|次列
second step|第二步
select line|選取一列
select none|全部不選
select word|選取單字
sensitivity|靈敏度
sentimental|抒情的
sequence-of|序列組
serendipity|意外收穫
serial line|序列線路
serial port|序列埠
server side|伺服器端
session key|作業階段金鑰
seventeenth|第十七
sexadecimal|十六進
shadow file|隱式檔案
shift-click|按住 Shift 再按一下
short usage|簡短用法
shown below|下面顯示的
side effect|副作用
significant|顯著的
signwriting|手語文
silent mode|無訊息模式
simple link|簡單鏈結
single step|單步
singularity|奇異性
size factor|尺寸因子
slot number|槽編號
small sheet|小張
smart phone|手機
solid black|單純黑色
solid brush|實線筆刷
solid color|單色
solid scope|密實
some people|某些人
sorting out|整理
sounds-like|發音相近
source code|原始碼
source file|原始碼檔案
source form|來源來自
source line|原始線索
source page|來源網頁
source path|原始碼路徑
south korea|南韓
spin button|微調按鈕
spline font|曲線字型
split words|分割單字
sponsorship|贊助
spool space|暫存空間
spreadsheet|試算表
springgreen|嫩綠
square root|平方根
stack frame|堆疊框架
staircasing|階梯效應
stand alone|獨立的
standardize|標準化
states that|顯示出
static-type|靜態類型
statistical|統計
status area|狀態區
status code|狀態碼
stay on top|最上層
stenography|速記
still image|靜態影像
stop motion|定格
stopped job|已停止的工作
story board|劇本
style sheet|樣式表
subclassing|子類別化
subdivision|線點間隔
sublanguage|子語言
submultiple|因數
subordinate|下屬
subprotocol|子協定
subsampling|次取樣
substantial|實質
successfull|成功
super block|超區塊
super+space|Super+Space
superscalar|超純量
superscript|上標
superselect|整體選取
suspectable|疑慮
sweepstakes|賭局
swiss franc|瑞士法郎
switchboard|交換機
switchpoint|交換點
switzerland|瑞士
symmetrical|對稱的
synchronize|同步
synchronous|同步的
syndication|聯合組織化
synthesizer|合成器
system beep|系統蜂鳴
system tray|系統匣
system wide|系統級別
tag library|標籤檔案庫
take a look|查看一下
take effect|生效
tarnsparent|透通的
teleservice|電訊服務
temperature|溫度
temporarily|暫時
term of use|使用條款
termination|終止
that is why|這就是為何
the correct|正確
the missing|缺少的
the present|現行的
there is no|沒有任何
third party|第三方
third-party|協力廠商
this is not|這不是
this scheme|這種方案
this screen|這個畫面
threatening|威脅
time of day|日中某時
time server|校時伺服器
timor-leste|東帝汶
to default"|為預設值
to disallow|表示不允許
to identity|為相同
to position|以定位
to serve as|當做
total score|總分
touchscreen|觸控螢幕
tracknumber|軌段編號
traditional|傳統
transaction|異動作業
transceiver|收發器
transcoding|轉換碼
transferred|已轉移
transformer|變換器
translation|翻譯
translucent|清澈的
transmitter|發送器
transparent|透明
transversal|橫越
tray object|系統匣物件
treble down|減弱高音
tree search|樹狀搜尋法
turn it off|關閉它
two or more|兩個以上
typographic|印刷
ultramarine|紺青
unavailable|不得使用
unconfigure|取消組配
underlining|加底線
unfavourite|取消收藏
unfortunate|不幸的
uninhibited|解禁
uninstalled|已解除安裝
uninstaller|解除安裝程式
unit number|單元號碼
unit string|單元字串
unnecessary|並非必要
unparseable|無法剖析的
unprotected|已取消保護的
unpublished|尚未發行
unqualified|資格不符的
unreachable|無法連線的
unsatisfied|未滿足的
unsolicited|不請自來的
unspecified|未指定
unsubscribe|退訂
unsupported|不受支援的
unvalidated|未驗證
upper bound|上限
upper limit|上限
upper right|右上
upper volta|上沃爾特
upside down|上下顛倒
user manual|使用手冊
utilization|效用
valid frame|有效碼框
view source|檢視原始碼
volga river|窩瓦河
volume down|降低音量
volume mute|靜音
vte-profile|虛擬終端機環境規範
wafer start|投片
wait longer|等久一點
wake island|威克島
walkthrough|逐步解說
warang citi|瓦郎奇蒂文字
wastebasket|回收筒
wasted time|所費時間
wave format|聲波格式
web address|網址
web manager|網頁管理者
well-formed|形式合宜
west indies|西印度
what you do|您在做什麼
white noise|白雜訊
white paper|白皮書
white space|空白
windowlevel|窗階
with itself|以其本身
without the|而無需
work around|變通方法
work online|線上工作
workstation|工作站
worry about|擔心
wrap around|回頭
wrap search|回頭搜尋
write it to|將它寫入
writebehind|延後寫入
yellow page|黃頁
yellowgreen|黃綠
yes for all|全部確定
you are now|現在您
your emails|hant-l10n@freelists.org
yue chinese|漢語粵語
zero-length|長度為零
zeroisation|歸零
zoom to fit|最適縮放
"alternative|另類
, as long as|衹要當
, as well as|以及
-be not -ing|沒有正在
a minute ago|一分鐘之前
abbreviation|縮寫
acceleration|加速
accomodation|住宿
according to|根據
account code|賬戶碼
action-label|動作標貼
action-reply|動作回應
active state|作用狀態
acute accent|揚音符
adaptability|適應性
add hardware|新增硬體
add new item|加入新項目
address book|通訊錄
alert volume|警示音量
align center|置中對齊
align to top|對齊頂端
all affected|全部受影響的
allow you to|允許您
alphabetical|依字母
alphanumeric|文數字
amalgamation|合併
anchor point|錨點
announcement|公告
another user|另一位使用者
antialiasing|美化字型
antiquewhite|古董白
arccotangent|反餘切
architecture|架構
archive-name|封存名稱
arrow button|箭號按鈕
arrow-curved|彎曲箭頭
as precedent|如同先前
asian indian|印度人
ask me again|再問我
aspect ratio|外觀比例
asturleonese|阿斯圖里亞斯語
asynchronous|非同步
at the front|位於前方
at this time|這一次
audio buffer|音效緩衝區
audio device|音效裝置
audio volume|聲音大小
audiographic|音訊圖形
authenticate|認證
auto advance|自動前進
auto-connect|自動連線
autocomplete|自動補完
autorollback|自動復原
autovertical|自動垂直
availability|可用性
bad checksum|不當的總和檢查
batch-export|批次匯出
be available|為可用
be closed to|不接受
be committed|已定稿
be continued|會延續
be no longer|不再
be not found|找不到
be not valid|無效
be sustained|有支援的
be there any|是否有任何
be unable to|無法
be you sure?|您確定嗎？
bear in mind|記在心上
beginning to|開始
best-efforts|盡力而為
beta version|測試版
bezier curve|貝兹曲線
bibliography|文獻目錄
billing data|賬單資料
biographical|自傳
blank screen|螢幕變黑
block length|塊長度
boolean type|布林值型態
boolean-list|布林列表
boot-manager|開機管理程式
bootstrapper|啟動載入器
border above|上框線
border below|下框線
bottom right|右下
bounding box|邊界框
bright green|鮮綠
buffer space|緩衝區空間
build number|組建號碼
burkina faso|布吉納法索
byelorussian|白羅斯
call waiting|話中插接
call-by-name|傳名呼叫
call-control|呼叫控制
calligraphic|美工
can not find|找不到
cancellation|取消通知
canonicalize|正則化
catalog file|目錄檔
cd-rom drive|光碟機
cell padding|儲存格內距
cell spacing|儲存格間距
center align|置中對齊
characterize|特性化
check forced|強制進行檢查
check to see|檢查看看
chiffon cake|戚風蛋糕
child branch|子分支
child status|子狀態
child widget|子視窗元件
child window|子視窗
chilean peso|智利披索
circumstance|情況
class number|類別編號
classic rock|經典搖滾
client-aware|顧及客戶端設定的
cluster size|磁簇大小
collaborator|協作者
collapse all|全部塌縮
color scheme|配色方案
column names|欄名
column width|欄寬
command mode|指令模式
commented on|對於發表了評論
commonwealth|國協
compensation|補償
compile time|編譯時期
complementer|互補器
concatenator|串接器
conditioning|調節
conductivity|傳導性
confidential|機密
configurable|可組配的
confirmation|確認
confirmed as|確認為
connectivity|連結
considerable|不少的
contact info|聯絡資訊
contact your|聯絡您的
contemporary|同時代的
content area|目錄區
context menu|快顯功能表
context-free|語境無關
continuation|延續
contradicted|扞挌
contribution|投送
control area|控制區
control file|控制檔
control item|控制項
conversation|會話
convert from|轉換自
corner point|設定角點
correct data|正確資料
could be -en|可供
counter hint|字腔修飾
counter mask|字腔遮罩
country code|國碼
cpu affinity|中央處理器親和度
cross-fading|畫面交替
cross-thread|跨執行緒
crossfooting|交互結算
crowdfunding|眾籌
cryptography|密碼學
cryptoperiod|密碼期間
cubic spline|三次曲線
current rank|現行等級
cylindricity|滾筒形狀
danish krone|丹麥克朗
darkseagreen|深海藻綠
data element|資料元素
data segment|資料區段
data-circuit|資料線路
day of month|月中某日
deactivation|停擺
dead process|無作用行程
decipherment|解密
dedicated to|專注於
definitively|確定要
deinterleave|去交錯
delay-loaded|延遲載入
depending on|依據不同的
depth cueing|景深暗示
derived from|衍生自
derived type|衍生類型
desaturation|稀化
deselect all|全部不選
desktop menu|桌面功能表
destination"|目的地
determine if|確定是否
dialog-based|對話框架構
did not find|找不到
did not have|並無
did you mean|您的意思是指
differ about|上有所不同
difficult to|難以
digitization|數位化
dimensioning|定尺寸
disassembler|反組譯工具
disconnected|已經結束連線
discontinous|不連續的
disjointness|解體
dismountable|可拆卸的
displacement|移位
display menu|顯示功能表
display name|代號
display size|顯示器尺寸
dissertation|博士論文
distribution|散佈
do not worry|別擔心
do the trick|順便一下
domino tiles|骨牌
dot notation|點記號
double arrow|雙箭頭
double click|連按兩下
double lines|雙線
double quote|雙引號
double-lined|雙列
double-sided|雙面
down-trodden|被欺壓的
downloadable|可下載
drag it here|拖曳到這裡
dramatically|大幅地
drawing area|繪圖區
drift factor|偏差因子
drivelistbox|磁碟列表框
drop-shadows|下落式陰影
dual-channel|雙通道
due tomorrow|明天到期
dynamic-type|動態類型
dynaset-type|動態集類型
earlier than|早於
edit control|編輯控制項
editing area|編輯區
elapsed time|經過時間
ellipse tool|橢圓形工具
embarrassing|尷尬
empty fields|空欄位
encipherment|加密
encyclopedia|百科全書
ending frame|終點影格
enough space|足夠的空間
entertaining|娛樂
entrepreneur|企業家
equivocation|雙關
error dialog|錯誤對話框
error number|錯誤代號
event-driven|事件驅動
example with|以為例
experimental|實驗性質
experts only|專家限用
fall through|落空
fast forward|正向快轉
feature code|特徵碼
feel free to|儘管
fiji islands|斐濟群島
file on disk|磁碟上的檔案
fill pattern|充填胚騰
first record|第一筆
fit the bill|正合所需
fixed-length|固定長度
flash memory|快閃記憶體
floppy image|軟碟映像檔
flow control|流量控制
flowcharting|流程圖製作
focal length|焦距
focus length|焦距
following be|下列是
font metrics|字型度量
food & drink|食物 & 飲料
for instance|舉例來說
for security|出於安全理由
fork process|叉生行程
fraction bar|分數線
fragmentable|可分段的
free account|免費賬號
free extents|可用範圍
free service|免費服務
freestanding|自存的
french franc|法國法郎
from scratch|從頭
full control|完全控制
full-purpose|通用
function key|功能鍵
galibi carib|加勒比語
gaussian fit|高斯擬合
german legal|德制法定
get in touch|與我聯絡
get involved|涉入
go to column|前往指定行
gone offline|離線
grab handles|抓取控點
graph theory|圖論
greater than|大於
group number|群組號碼
group vector|群組集合
guard clause|衛述句
hall of fame|榮譽榜
hand in hand|攜手
happen again|再次發生
haptic touch|力度觸控
have not yet|尚未
have written|已寫入
header field|標頭欄位
headquarters|總部
hierarchical|階層式
high-density|高密度
higher level|較高階
higher-order|高次
home address|住址
host machine|主機電腦
hot-plugging|熱插式
housekeeping|事務類工作
how and when|方式與時機
hybrid sleep|混合睡眠
hyphen-minus|連字減號
identifiable|可識別
if available|如果有的話
if necessary|如果必要的話
illumination|照明
illustration|圖例
image number|影像號碼
in %1 second|於 %1 秒後
in %2 second|於 %2 秒後
in %d minute|於 %d 分鐘後
in %d second|於 %d 秒後
in %g second|於 %g 秒後
in %i minute|於 %i 分鐘後
in %s minute|於 %s 分鐘後
in %s second|於 %s 秒後
in %u second|於 %u 秒後
in any event|在任何狀況下
in dual-pane|在雙窗格中
in file name|在檔名中
in last week|上星期
in next week|下星期
in that case|在該例中
in the cloud|在雲端
in the drive|在光碟機中
in this case|在這種情況下
inaccessible|不可存取
inbox driver|內附驅動程式
include file|包含檔
incompatible|不相容的
inconsistent|不一致
independence|獨立度
index finger|食指
indian rupee|印度盧比
indic-telugu|印度－特拉古語
infringement|侵權
inline frame|內聯框架
inner shadow|內側陰影
input levels|輸入色階
input method|輸入法
input stream|輸入流
input volume|輸入音量
installation|安裝
instantiated|實例化
instrumental|純樂器演奏
insufficient|不足的
integer type|整數型態
intended for|適用於
interconnect|互相連接
interest you|您會有興趣的
intermediary|中介程式
intermediate|中介
interoperate|互通
intervention|介入
interworking|交互作用
intra-office|局內
introduction|介紹
invalidation|無效化
it's time to|是時候該
japanese yen|日圓
joint-stereo|聯結立體
judeo-arabic|猶太－阿拉伯語
jurisdiction|司法管轄
just another|又一個
just in case|萬一
just in time|及時
keep in mind|請留意
kernel panic|內核崩壞
key material|金鑰材料
key strength|金鑰強度
key features|金鑰特徵
kill process|砍除行程
landing page|登陸頁面
languedocien|朗克多格語
last version|最新版本
late-binding|晚期繫結
latvian lats|拉脫維亞拉特
lay them out|將其配置版面
layered pane|分層窗格
layout style|編排樣式
leading zero|前置字元為零
least square|最小平方
leave behind|留下
left justify|靠左對齊
left-justify|左調
legal issues|適法問題
legal notice|法律注意事項
lemonchiffon|粉黃
lens control|光圈調整
level number|層次數
light orange|淺橙
light purple|淺紫
light source|光源
light yellow|淺黃
light-weight|輕巧
lightskyblue|淺天藍
line endings|列尾結束符號
line profile|曲線輪廓
line segment|線段
line spacing|列距
link-by-link|鏈路對鏈路
local object|區域物件
local server|本機伺服器
local symbol|本機符號
localization|本地化
location bar|位置列
log messages|記錄訊息
log rotation|記錄自動重建
logfile path|記錄檔案路徑
logged in as|登入為
logical bank|邏輯記憶體庫
logical font|邏輯字型
logical view|邏輯檢視
login screen|登入畫面
login window|登入的視窗
lookup table|查找表
low priority|低度優先
low security|低度安全
low-asserted|低插入
lower branch|下層分支
luba-katanga|盧巴－加丹加語
machine code|機器碼
mail address|郵件地址
mailing list|郵遞論壇
main toolbar|主工具列
major device|主裝置
make visible|顯現
maltese lira|馬爾他里拉
mangled name|毀壞的名稱
manipulation|處理
manual break|手動分隔
manual entry|手冊條目
manufacturer|製造商
marked empty|標記為空
market place|市場
match prefix|字首須符合
match-string|符合字串
mathematical|數學的
maximization|最大化
maximum size|最大容量
maximumerror|最大錯誤量
mediumorchid|暗蘭花紫
mediumpurple|暗紫
meetei mayek|曼尼普爾文
meitei mayek|曼尼普爾文
memory space|記憶體空間
memory-based|以記憶體為基礎的
menu command|功能表指令
menu entries|功能表條目
mesh network|網狀網路
message area|訊息區
meta-content|中繼內容
metalanguage|中繼語言
microprogram|微程式
middle click|單擊中鍵
midnightblue|黑藍
minicomputer|迷你電腦
minor device|次級裝置
minor number|次級號碼
mixer device|混音裝置
mnemonic key|快捷鍵
mobile phone|行動電話
modal dialog|強制前景對話框
modal window|強制前景視窗
mode of file|檔案模式
modification|修改
modifier key|輔助按鍵
module-level|模組層次
more matches|更多符合者
most current|最新
mouse inside|滑鼠進入
move forward|向前移動
move quickly|快速移動
multi-access|多重存取
multi-column|多重欄位
multi-extent|多重延伸區
multi-thread|多執行緒
multicasting|多點傳送
multiconnect|多重連接
multilingual|多語言
multiplexing|多工
multiplicand|被乘數
multiplicity|多重性
multisession|多重區段
multitasking|多工處理
music volume|音樂音量
name element|名稱元素
nested class|巢式類別
network down|網路斷線
network port|網路埠
neutral zone|中立區
nevertheless|無論如何
next chapter|下一章節
nomenclature|命名法則
non-blocking|非阻斷
non-existant|不存在
non-seekable|無可尋取的
non-volatile|非揮發性質
none of them|它們沒有任何一個
nonoperating|不可操作的
not equal to|不等於
not even for|甚至不含
not point to|未指到
not possible|不可能
not too hard|不大困難
notarization|公證
notification|通知
null pointer|空指標
number forms|數字形式
numeric base|數值基礎
numeric data|數字資料
numeric type|數字類型
object types|物件型式
occasionally|偶爾
office suite|辦公套裝軟體
on behalf of|代表
on the right|右側的
on their own|自行
once a month|一月一次
one of these|其中之一
one piece of|一條
one place up|向上一個位置
only contain|衹含有
open bracket|空方括號
open element|開啟元素
open message|開啟電子郵件
optical disk|光碟
optimization|最佳化
optionbutton|選項按鈕
order number|訂購編號
organisation|團體
organization|團體
oscilloscope|示波器
out of order|故障
out of reach|夠不到
out of space|超出空間
out-of-frame|失框
outline font|大綱字型
outline view|大綱檢視
outside line|外線
over-receive|超收
over-written|覆寫
overlay-blue|外覆－藍
overlay-gray|外覆－灰
oversampling|超取樣
owner window|主控視窗
page printer|頁印表機
pahawh hmong|楊松錄苗文
parent notes|上層節點
participatio|參與
pass through|轉送
pass-through|傳遞
patent troll|專利流氓
peak-to-peak|峰至峰
pertinent to|與有關
phase number|相位號碼
phase-locked|鎖相
phone dialer|電話撥號員
phone number|電話號碼
photographic|逼真的
place window|視窗置於
play-by-play|詳實的
please do so|請照這樣做
pointer type|指標型態
polymorphism|多型
pornographic|色情
power ballad|強力流行抒情
power button|電源按鈕
power of two|二的次方
power saving|節約能源
power source|電源
power supply|電力供應器
prc envelope|中式信封
pre-emphasis|預先加強
pre-generate|預產生
precondition|前提
preferential|優先
premastering|前置主控
preparing to|準備
preprocessor|前置處理器
prescription|處方
preselection|預先設定
presentation|簡報
pretty print|美觀印出
preview area|預覽區
primary link|主鏈結
prime factor|質因數
prime number|質數
principality|侯國
print across|列印跨頁
private node|私有節點
process fail|行程故障
process name|行程名稱
process with|行程具有
productivity|生産力
professional|專業
profile file|規範檔
program unit|程式單元
programmable|可程式化
proofreading|審閱
property set|性質集
proportional|比例
provisioning|供給
proxy server|代理伺服器
pseudo-color|假擬顏色
pseudorandom|假擬隨機
pseudotarget|假擬目標
pull request|拉取請求
quantitative|定量
quantity set|量集
quantization|量化
quickstarter|快速啟動
quilting bee|拼布會
quit without|離開但不
radio button|單選按鈕
radionuclide|放射性質核種
raise to top|提到最上層
reachability|可抵達性
read through|看過
reassembling|重組
recent files|最近使用的檔案
record macro|錄製巨集
record start|記錄起始
record-level|資料錄層級
records out"|項記錄寫出
redefinition|重複定義
redistribute|再次散佈
refresh rate|重刷速率
registration|註冊
registry key|註冊表索引鍵
reinitialize|重新初始化
reinstalling|重新安裝
rel-rational|相對有理數
relationship|關聯性
remain whole|維持完整
repeat count|重複次數
replace with|置換成
reply to all|回給全部
reproducible|可再生
reproduction|再製生產
resequencing|重新定序
resolve name|解析名字
restore down|下拉還原
return cause|回覆原因
reverse scan|倒放掃描
right margin|右邊界
right-handed|慣用右手
romanian leu|羅馬尼亞列伊
root account|root 賬號
root element|根項目
rotate right|向右旋轉
rowheightmin|資料列最小高度
rwanda franc|盧安達法郎
saint helena|聖赫倫那島
saint martin|聖馬丁
saudi arabia|沙烏地阿拉伯
save copy as|另存副本
save file as|檔案另存為
save file to|存檔到
scale factor|伸縮比值
scale to fit|最適比例
screen saver|螢幕保護程式
screen space|螢幕空間
search order|搜尋順序
section name|節段名稱
section sign|段落符號
segmentation|分段
selected row|所選列
semi-trusted|非完全信任
semiexpanded|半伸展
send to back|移到最下層
service-user|服務使用者
session name|區段名稱
setting tile|設定圖塊
severability|合約可分割性
sharing mode|共用模式
shell script|命令稿
shortcut key|快捷鍵
shorter than|短於
side by side|一齊
sierra leone|獅子山
signal level|信號位準
simple-bound|簡單繫結
simultaneous|同步
single click|按一下
sino-tibetan|漢藏
sint maarten|聖馬丁
smaller than|小於
snap to grid|貼齊格線
solarization|曝光
solicitation|懇求
someone else|其他人
sora sompeng|索朗桑朋文字
sort by date|依據日期排序
sort by name|依據名稱排序
sort by size|依據大小排序
sound volume|聲音音量
south africa|南非
specifically|指明
spelling bee|拼字會
split-screen|分割畫面
sranan tongo|蘇利南東墎語
staging area|整備區
step forward|前進一格
stereoscopic|立體影像
sticky notes|黏貼式便條紙
storage card|記憶卡
storage pool|貯藏池
storage size|貯藏大小
straightness|直線
stream start|串流起點
sub-division|次部門
subdatasheet|子資料工作表
subdirectory|子目錄
subscripting|下標
subscription|訂用
substitution|替代
suitable for|適用
supplemental|補充
syloti nagri|錫爾赫特文
synchronized|同步的
syrian pound|敘利亞鎊
table header|表頭
table number|表號碼
table-column|表格欄
take a guess|猜一下
take a while|花費一點時間
take care of|照顧
task manager|工作管理器
terse output|壓縮輸出
tessellation|鑲嵌
text-to-text|字元高度
the thing is|問題是
theme to use|要用的佈景主題
then-current|當時公認的
there are no|沒有
this kind of|這一類
this release|這次釋出
thoughtfully|經過周詳考慮
thousands of|數以千計的
thrash metal|鞭撻金屬
thumb symbol|縮圖符號
time elapsed|經過時間
time-limited|限時
onsite|現場
before you continue|在您繼續之前
on-site|現場
on site"|在場
time-based|基於時間的
time-slicing|劃分時間片段
to make sure|以確定
too small to|太小而無法
transferable|可轉讓
transitional|轉變的
transmission|傳輸
transmitting|傳輸中
transparency|透明度
treble-click|連按三下
triple-click|按三下
troubleshoot|疑難排解
truncated to|截短至
trusted site|信任的網站
turkish lira|土耳其里拉
turkmenistan|土庫曼
turn this on|將其開啟
type of data|資料型式
type of link|鏈結類型
unauthorised|未經授權的
unauthorized|未經授權的
unclassified|未分類
uncompressed|未壓縮的
unconference|非正式會議
unconfigured|未組配的
unhappy with|不滿意
uninstalling|解除安裝
unmarshaling|解封送處理
unreasonable|不合理的
unrecognised|無法辨識的
unrecognized|無法辨識的
unrestricted|無限制的
unsharp mask|去銳利化遮罩
unstructured|無結構的
unsuccessful|不成功
unterminated|未終結的
unused space|未使用的空間
up one level|往上一層
upper branch|上層分支
use-priority|優先用途
user control|使用者控制項
user defined|使用者自訂
user to user|使用者至使用者
user-defined|使用者定義的
user-element|使用者元件
vector table|向量表
verbose mode|詳細模式
verification|核實
vertical bar|垂直列
virtual root|虛擬根目錄
visible grid|可視網格
visited link|造訪過的鏈結
volume group|卷冊群
volume level|音量大小
volume meter|音量計
volume muted|已設靜音
waiting list|備取名單
walk through|遍閱
we are sorry|我們感到抱歉
wedding cake|結婚蛋糕
welcome back|歡迎回來
what kind of|什麼樣的
when enabled|一旦啟用
whole spread|整版
wide variety|廣泛
window frame|視窗框架
window-based|以視窗為基礎的
without -ing|而毋須
work address|公司地址
work offline|離線工作
working file|工作檔案
writethrough|寫到底
years and up|歲以上
years of age|歲
you can then|然後您能夠
"on behalf of|謹代表
%s : %d of %d|%1$s：%3$d 中的 %2$d
%s : %i of %i|%1$s：%3$i 中的 %2$i
%s : %s of %s|%1$：%3$s 中的 %2$s
%s : %u of %u|%1$s：%3$u 中的 %2$u
(S) teal lock|竊取鎖定
-delay before|之前產生延遲
-have not -en|未
a few minutes|幾分鐘
a few seconds|幾秒鐘
a new kind of|一種新的
access denied|拒絕讀取
access number|存取號碼
accessibility|輔助工具
accommodation|住宿
activity slot|活動項目
activity type|活動型式
address field|地址欄
address space|位址空間
administrator|管理者
administrivia|管理工作
advance width|步進寬度
advertisement|廣告
airplane mode|飛航模式
aland islands|奧蘭群島
align to left|靠左對齊
alpha channel|透明色版
alpha-numeric|文數字
always on top|最上層
and much more|以及更多
and operation|及運算
and try again|並再次嘗試
angle bracket|角括號
another place|另一個位置
antilogarithm|反對數
anything else|其他任何事
appreciate it|對此感謝
armenian dram|亞美尼亞德藍
array element|陣列元素
as an example|舉例來說
associativity|順序關聯性
astonishingly|令人驚訝地
at some point|偶爾
at the bottom|位於底部
at the moment|目前
atomic number|原子序
atomic radius|原子半徑
atomic volume|原子容量
atomic weight|原子量
audio control|音效控制
authenticated|已認證
authorization|授權
auto exposure|自動曝光
auto-rollback|自動返回
autocalculate|自動計算
autonumbering|自動編號
available for|可見於
average value|平均值
award-winning|得過獎的
backing store|背景儲存
bad parameter|不當參數
battery level|電池電量
battery power|電池電力
be aware that|請注意
be capable of|有能力
be limited to|受限為
be located in|被放置在
be logged out|登出
be made up of|所組成由
be not listed|還沒有列出
be opposed to|反對
be subject to|受規範於
be up-to-date|已更新
before saving|儲存之前
belgian franc|比利時法郎
below you can|以下您能夠
bidirectional|雙向
big thanks to|非常感謝
binary stream|二進資料流
bitmap glyphs|點陣字圖
block of text|文字區段
boiling point|沸點
bolivian peso|玻利維亞披索
bookmark this|書籤加入
born this way|天生如此
bottom margin|下邊界
breakout room|分組討論室
brunei dollar|汶萊元
bulgarian lev|保加利亞列弗
bullet points|項目符號
burundi franc|蒲隆地法郎
button number|按鈕號碼
calendar time|日曆時間
call by value|傳值呼叫
call duration|通話時間
cd image file|CD 映像檔
cd-recordable|可錄式光碟
cd-rewritable|可抹寫式光碟
certification|憑證
chamber music|室內樂
character set|字元集
check this to|勾選這項以
chhattisgarhi|恰蒂斯加爾語
child control|子控制項
child process|子行程
christian rap|基督教饒舌
chronological|時序
click here to|按一下這裡以
client-server|主從式
close session|關閉區段
cluster-ready|具備叢集能力的
code settings|代碼撰寫設定
collaboration|協同作業
collaborative|協同
collapse from|塌縮自
collapse tree|塌縮樹狀結構
collection of|收藏
color channel|色版
color palette|調色盤
come in handy|會覺得好用
come in pairs|成對出現
come together|一齊來
comes with no|沒有附帶任何
communication|通訊
comparable to|可對應於
compared with|相較於
compatibility|相容性
complementary|補色
complex-bound|複雜繫結
comprehension|理解力
comprehensive|詳盡的
concatenation|串接
confederation|邦聯
config-reader|組態讀取器
configuration|組態
configure how|組配方式
consequential|隨之而來的
consideration|注意事項
contradictory|矛盾的
control class|控制項類別
control panel|控制臺
copyright law|著作權法
cote d'ivoire|象牙海岸
create cursor|建立資料指標
croatian kuna|克羅埃西亞庫那
cross-connect|交接
cross-posting|跨板張貼
cryptanalysis|密碼分析法
cryptographic|密碼學的
current month|當月
customization|客製化
cyanobacteria|藍綠菌
cycle through|重複循環
dai languages|傣語諸語言
darkgoldenrod|深金黃
darkslateblue|深青藍
darkslategray|深青灰
darkturquoise|深粉藍
dash patterns|虛線胚騰
date of birth|出生日期
decimal digit|十進數位
decimal point|十進小數點
decimal-point|小數點
declared here|在這裡宣告
decomposition|分解
delimiter set|分隔符號集
demonstration|演示
demultiplexer|解多工器
dependability|可依存性質
dereferencing|取值
detailed view|細節檢視
deterministic|確定
deutsche mark|德國馬克
device number|裝置編號
device-mapper|裝置映射程式
dimensionless|無尺寸的
direct access|直接存取
discovered by|發現者
discretionary|任意的
dispinterface|分配介面
display group|顯示群
display order|播放次序
document menu|文件功能表
document type|文件型式
documentation|文件
documented by|文件作者
does not name|非稱為
domain object|網域物件
domain socket|場域通訊端
drag and drop|拖放
dropped frame|掉失影格
dvd-rom drive|光碟機
early-binding|早期繫結
eavesdropping|竊聽
email address|電子郵件地址
email program|郵件軟體
embellishment|添加
empty archive|空的封存
encapsulation|封裝
environmental|環境
error details|錯誤細節資訊
error handler|錯誤處理常式
error message|錯誤訊息
establishment|建立
evenly divide|平衡劃分
ever-changing|百變
exit normally|正常退出
explicit link|外顯鏈結
exported file|匯出檔案
exposure time|曝光時間
extensibility|擴充性
external page|外部網頁
extraexpanded|特伸展
factorization|因數分解
faroe islands|法羅群島
fibre channel|光纖通道
figure it out|應變
fill to right|向右充填
find in files|多重檔案尋找
find previous|找上一個
floating type|浮點資料類型
flying height|飛行高度
for some time|有一段時間
forgot to use|忘記了使用
fragmentation|分段
frame grabber|影格抓取器
framing error|框架錯誤
french guiana|法屬蓋亞那
friendly name|易記名稱
from template|取自模本
fully justify|左右對齊
function name|函數名稱
function type|函數型式
functionality|功能性
gaussian blur|高斯模糊
geared toward|目標朝向
germanfraktur|日爾曼體
grant-control|授與控制
granularities|精細度
graphics card|顯示卡
greek drachma|希臘德拉克馬幣
guinea-bissau|幾內亞比索
guyana dollar|蓋亞那元
hakka chinese|漢語客家語
harmonization|調和
hash function|雜湊函數
have at least|至少有
have occurred|發生了
have received|已收到
have suffered|遭遇到
header button|標頭按鈕
hebrew visual|希伯來語(左至右)
here-document|立即文件
heterogeneous|異質性
high security|高度安全
highest voted|獲得最高票的
home computer|家用電腦
host computer|主電腦
hot-pluggable|可熱插式的
human-factors|人因
humanreadable|易讀的
hyperdocument|超文件
ijo languages|伊喬諸語言
ill-condition|病態情況
image gallery|影像圖庫
image-editing|影像編輯
impersonation|假冒
implicit link|隱含鏈結
impossible to|無法
in last month|上個月
in new window|在新視窗中
in next month|下個月
in particular|尤其
in some cases|在某些情況下
in the center|位於中央
in the future|在未來
inappropriate|不適宜的
incoming call|收信呼叫
inconsistency|不一致
inconvenience|不方便
indeterminate|不定
indic-bengali|印度－孟加拉語
indic-kannada|印度－卡納達語
indic-punjabi|印度－旁遮普語
infinite loop|無窮迴圈
informational|參考性
injected dose|注射劑量
inscriptional|碑銘體
instantiation|實例化
instification|對齊
integral type|整數類資料類型
intentionally|有意地
interested in|有興趣
intermateable|可互配
international|全球的
interoperable|可交流的
interpolation|內插法
interprtation|判讀
interrogating|查詢
introspection|內視
invalid frame|無效框
inverse video|反白顯示
it seems that|似乎
jinyu chinese|漢語晉語
journal entry|流水賬條目
judeo-persian|猶太－波斯語
justification|調整
katakana half|半形片假名
keep this low|保持較低數值
keep track of|記錄
key agreement|金鑰協定
key component|金鑰組件
knowledgebase|知識庫
kra languages|仡央諸語言
kru languages|克魯諸語言
language-name|漢語官話
last modified|上次修改日期
last position|上一個位置
lavenderblush|淡紫紅
layout object|編排物件
left or right|向左或向右
left to right|從左到右
lexical scope|詞彙範圍
liechtenstein|列支敦斯登
light magenta|淺紫紅色
lighter fluid|打火機油
lightseagreen|淺海藻綠
line wrapping|換列
linked object|鏈結化物件
little endian|低位在前
local folders|本機資料夾
local machine|本機電腦
local printer|本機印表機
logical block|邏輯塊
logical value|邏輯值
login process|登入行程
look and feel|外觀感覺
loose binding|寬鬆繫結
lost password|遺失密碼
lower sorbian|低地文德語
luxembourgish|盧森堡語
magnetic line|磁力線
magnetic tape|磁帶
magnification|放大
mahjong tiles|麻將牌
major release|重大釋出版本
make a choice|做一選擇
make featured|定為特色
make no sense|不具任何意義
manual layout|線上手冊的版面佈局
mark-to-space|標間
marker object|記號物件
master volume|主音量
mathematical"|數學
maximum speed|極速
medical image|醫學影像
melting point|熔點
mende kikakui|門德文
menu contents|功能表內容
message board|留言板
message store|訊息庫
metacharacter|中繼字元
middle finger|中指
minor version|次級的版本
miscellaneous|雜項
modifier tone|修飾音調
more detailed|更多細節的
more pleasing|更佳的
most recently|最近
mother tongue|母語
mouse capture|滑鼠捕捉
move backward|向後移動
move to trash|丟進回收筒
movie control|影片調控
moving around|四處移動
multi session|多重區段
multi-extract|多重抽出
multi-process|多重處理
multithreaded|多重執行緒
n-dimensional|Ｎ維
national folk|民俗歌謠
nesting level|巢式層級
network-based|以網路為基礎的
never defined|從未被定義
new caledonia|新喀里多尼亞
no space left|沒有剩下空間
non-interlace|非交錯
non-intrinsic|非內建
non-mandatory|非必要
non-permanent|非永久性質
non-recursive|非遞迴
normal window|標準視窗
normalization|常態化
not available|無法使用
not installed|未安裝
not specified|未指定
not supported|不支援
nothing found|找不到任何東西
nothing to do|無事可做
numbered list|編號串列
numeric forms|數字形式
object detail|物件細節資訊
object module|目標模組
objectionable|令人反感
off-the-shelf|現成的
on by default|預設開啟
once selected|一旦選取之後
only requires|衹需要
only used for|衹用於
opening hours|開放時間
option spread|期權價差
options below|以下選項
original path|原始路徑
original size|原件大小
orphaned file|孤立的檔案
out of memory|記憶體不足
out of office|不在辦公室
out-of-memory|記憶體耗盡
outgoing call|去訊呼叫
outgoing mail|外寄的郵件
outline color|外框顏色
output levels|輸出色階
output volume|輸出音量
over the spot|近點
overlay-green|外覆－綠
package-label|套件標貼
page-sequence|頁序列
palegoldenrod|淡金黃
paleturquoise|淡藍綠
palevioletred|淺紫紅
paragraph end|段落的結束位置
parallel port|並列埠
parallelogram|平行四邊形
participation|參與
pass by value|傳值
paste special|專選貼上
perpendicular|垂直
personal file|個人檔案
pertaining to|有關於
peruvian inti|祕魯因蒂
physical bank|物理記憶體庫
physical line|物理線路
players leave|玩家離去
playing sound|聲音播放
plug and play|隨插即用
point of view|的觀點而言
popup blocker|彈出式阻斷器
portrait left|螢幕向左轉直
postprocessor|後置處理器
power manager|電力管理器
pre-installed|預載
preparing for|準備
prerequisites|先決條件
press release|新聞稿
prevarication|推諉
previous page|上一頁
print preview|預覽列印
print version|印出版本
printing task|列印作業
priority over|優先於
privated-user|專用者
probabilistic|機率式
progress bars|進度條
proper subset|真子集
property-list|性質列表
pseudo-column|假擬資料欄
pseudo-device|假擬裝置
pseudo-random|假擬隨機
public domain|公共財
public folder|公共資料夾
public object|公共物件
quadrilateral|四邊形
qualification|合格
question mark|問號
radio station|無線電臺
random number|亂數
random offset|偏移隨機
range to show|顯示的範圍
rasterization|柵格化
read commands|讀取指令
rearrangement|重新編排
received data|接收數據
received from|已接收自
recent enough|時間夠近
recently used|最近使用過
record format|錄格式
record marker|條目標記
record number|條目號碼
record status|錄音狀態
redeclaration|重新宣告
regardless of|而不管
register-true|正反頁的列距相等
registered as|註冊成
relative link|相對鏈結
relative path|相對路徑
release build|釋出的組建
release notes|釋出說明
repeated once|重複了一次
report to the|報告給
required from|需求來自
reserved area|保留區
reserved name|保留名稱
reserved word|保留字
resynchronize|重新同步化
retrospective|回頭
return option|回覆選項
reverse video|反白顯示
rhythmic soul|節奏靈魂樂
right justify|靠右對齊
right to left|從右到左
right-justify|右調
right-to-left|由右到左
root password|Root 密碼
rotated files|輪轉的檔案
rounded edges|邊角變圓
rounding mode|捨入模式
run-time-only|僅限執行階段
san francisco|舊金山
screen reader|螢幕助讀員
script family|手寫體字族
security risk|安全上的風險
see you later|待會兒見
selected text|所選文字
selection box|選取方塊
self-relative|自行相對
semiautomatic|半自動
semicondensed|半緊縮
semiconductor|半導體
separator bar|分隔線
serial number|序號
serialization|序列化
series number|系列號碼
server-client|伺服器－客戶端
session layer|會談層
set correctly|正確設定
settings file|設定檔
setup package|安裝套件
shared memory|共用記憶體
shared object|共用物件
sharp corners|銳化邊角
shutter speed|快門速度
sign language|手語
significantly|顯著
silvery-white|銀白色
single-buffer|單緩衝區
sleeplessness|失眠
snapshot file|快照檔
sorting order|排序依據
source format|原始格式
source medium|來源媒體
southern rock|南方搖滾
space-to-mark|間標
special paste|專選貼上
specific heat|比熱
specification|規格
splash screen|軟體資訊畫面
splash window|軟體資訊視窗
spring-loaded|自動開合式的
sprocket hole|齒孔
stained glass|有色玻璃
start address|起始位址
start of line|列起始端
state machine|狀態機
step backward|後退一格
storage class|貯藏類別
storage-class|貯藏類型
straight arms|直臂
straight line|直線
stream header|串流標頭
streams-based|以串流為基礎的
strikethrough|刪除線
sub-authority|次機構
sub-committee|次委員會
subexpression|子運算式
submultiframe|次多重影格
subnet number|子網路編號
subscriptions|訂閱
supercomputer|超級電腦
supplementary|輔助的
swedish krona|瑞典克朗
system number|系統編號
system object|系統的物件
tab character|跳格字元
table heading|表頭
tabloid extra|小報特規
tai languages|台語諸語言
tai xuan jing|太玄經
take a moment|花費一點時間
take snapshot|拍下快照
tell me again|再告訴我
thank you and|謝謝您，同時
thank you for|謝謝您的
the following|下列
there is only|衹有
this does not|這不會
this is handy|如此將會很好用
threatened to|預示要
time critical|關鍵時間
to lower case|轉換為小寫
to upper case|轉換為大寫
top to bottom|從上到下
traditionally|傳統上
transfer rate|轉移速率
translated by|翻譯者
transliterate|實字轉譯
turn this off|將其關閉
type-specific|型態特定的
ultraexpanded|超伸展
uncategorized|未分類的
unenforceable|無法執行
unfortunately|不幸
uninteresting|無趣的
united states|美國
upper sorbian|高地文德語
upwards arrow|向上箭號
variable font|變寬字型
vast majority|大多數
verbose debug|詳細除錯資訊
vertical line|垂直線
vertical text|直排文字
video gallery|影片庫
view position|視象位置
virtual space|虛擬空間
visual design|可視設計
visual editor|可視編輯器
visualization|視覺化
vte-parameter|虛擬終端機環境參數
vulnerability|弱點
watch out for|當心
well grounded|站得住腳
where it goes|它的去處
white balance|白平衡
window header|視窗標頭
without error|無誤
word argument|文字引數
word boundary|字緣
work properly|正常運作
work together|合作
worker thread|背景工作執行緒
working group|工作群組
working hours|工作時數
would like to|想要
write-through|寫到底
xiang chinese|漢語湘語
you'd like to|您會想要
-be as follows|如下
64-bit edition|64 位元版
abnormally big|過大
about yourself|關於自己
abstract class|抽象類別
accountability|可歸責性
acknowledgment|認可
active content|主動式內容
addressability|可定址能力
administration|管理
administrative|管理者
aegean numbers|愛琴數字
aggregate type|聚合型式
algerian dinar|阿爾及利亞戴納
align to right|靠右對齊
alpha blending|透明混成
already in use|已在使用中
always visible|一律顯現
american samoa|美屬薩摩亞
amount of time|一段時間
analog-digital|類比數位
angle-measured|角度
archive header|封存標頭
argentine peso|阿根廷披索
as it does not|因其不
as last resort|做為最後一招
asymptotically|漸近
at your option|您自行選擇的
atlantic ocean|大西洋
attribute type|屬性型式
authentication|認證
auto increment|自動增量
autocompletion|自動補完
autotransition|自動轉換
auxiliary file|輔助檔案
available here|可在這裡取得
back reference|回溯參考
base directory|基準目錄
be addicted to|上癮
be first found|首次發現
be not allowed|並不允許
be not applied|並不適用
be not enabled|還沒有啟用
be now running|現在執行中
be superior to|優先於
be turned into|被轉換為
big thanks for|非常感謝
blanchedalmond|杏仁白
block boundary|區段界限
block-oriented|區段導向的
blood fraction|血液成分
bounce message|退件訊息
brazilian real|巴西里耳
bridge element|橋接元件
bring to front|提到最上層
building block|組建區塊
built-in macro|內建式巨集
button control|按鈕控制項
by description|依描述
can be used to|可用於
can not handle|無法處理
capability set|能力集
capitalization|大寫
caret browsing|鍵盤瀏覽
cascade window|重疊顯示
case sensitive|大小寫相符
case statement|條件敘述
cc attribution|創用 CC 姓名標示
channel number|通道編號
chapter number|章節編號
character code|字元碼
character type|字元型式
characteristic|特性
chinook jargon|奇努克混合語
christian rock|基督教搖滾
circle-outline|圓圈
classification|分類
clock register|鐘訊暫存器
code converter|碼轉換器
code generator|程式碼產生器
collate copies|自動分頁
column headers|資料欄標頭
command prompt|指令提示符號
complete it to|將它補完為
complete table|完整表
complex number|複數
component name|組件名稱
component type|組件型式
composite type|組合型式
congratulation|恭喜
connect to all|全部連線
connectionless|免接式
constant value|常數
constraint set|限制集
contact server|連上伺服器
context string|情境字串
core component|核心組件
cornflowerblue|矢菊花藍
correct answer|正確答案
corresponds to|相應於
could not find|找不到
counter-notice|反對通知
counterfeiting|仿冒
countermeasure|對策
covered option|備兌性期權
critical error|嚴重錯誤
croato-serbian|克羅埃西亞塞爾維亞語
cross-compiler|交叉編譯器
cross-platform|跨平臺
custom control|自訂控制項
czech republic|捷克
darkolivegreen|深橄欖綠
data integrity|資料完整性
data tag group|資料標籤群
debugging tool|除錯工具
decimal places|小數點位數
defend against|對抗
deinstallation|移除安裝
deleted object|已經刪除的物件
demultiplexing|解多工
dequantization|解量化
desynchronizer|解同步器
device context|裝置情境
device details|裝置細節資訊
dial on demand|視需要撥號
digital camera|數位相機
direct connect|直接連接
direct message|私人訊息
directory tree|樹狀目錄
discharge time|出院時間
discovery date|發現日期
disk partition|磁碟分割區
dispatch table|派送表
divide by zero|被零除
do not have to|不須
do you mind if|您會介意如果
domain knowhow|場域實力
dominican peso|多明尼加披索
drop us a note|留個訊息給我們
drop-down menu|下拉式功能表
dummy argument|虛引數
dvd image file|DVD 映像檔
e-mail address|電子郵件地址
easy listening|輕音樂
egyptian pound|埃及鎊
element number|元件號碼
empty document|空白文件
encryption key|加密金鑰
error category|錯誤種類
error occurred|發生錯誤
error recovery|錯誤復原
error response|錯誤回應
ethernet cable|乙太網線
ethiopian birr|衣索比亞比爾
euler's number|尤拉數
event calendar|行事曆
exclusive lock|專用鎖定
exists already|已經存在
expected value|預期值
external label|外標貼
extracondensed|特緊縮
extremely slow|極度緩慢
extremum bound|極值範圍
false positive|假警報
feel confident|覺得舒服
field of study|科系
file extension|副檔名
file hierarchy|檔案階層
file operation|檔案操作
file selection|選取檔案
file specified|指定的檔案
fill character|充填字元
fill downwards|向下充填
finnish markka|芬蘭馬克
floating point|浮點數
floating-point|浮點
for assistance|以獲得協助
format of file|檔案格式
formatted file|格式化的檔案
freeze-picture|凍結圖象
general entity|通用實體
general ledger|總賬
git repository|Git 程式庫
global default|全域預設值
grand duchy of|大公國
growing medium|培養基
hardware setup|硬體安裝
have forgotten|忘記了
have timed out|已逾時
high order bit|高位位元
hollow diamond|空心菱形
home directory|主目錄
horizontal bar|水平線
horizontal tab|水平跳格
how many times|多少次
human-readable|容易理解的
hypertext link|超文字鏈結
identification|識別
if and only if|若且惟若
if-and-only-if|等值計算
implementation|實作
in %s encoding|以 %s 編碼
in addition to|除了
in description|在描述中
in near future|不久
in other words|換句話來說
in parentheses|在括號中
in parenthesis|在括號中
in-development|開發中的
infrastructure|基礎架構
initialization|初始化
inplementation|實作
installed size|安裝後大小
instrument the|提供
interface-data|介面資料
interoperation|相互運作
interpretation|詮釋
intractability|不可駕馭度
ipa extensions|國際音標擴充
it is possible|是有可能
jurisdictional|司法管轄權
just as before|就如同以往
keep an eye on|留意
keep this high|保持較高數值
kernel-tunable|內核可調的
key identifier|金鑰識別碼
key management|金鑰管理
keynote speech|主調演講
knowledge base|知識庫
landscape mode|橫向模式
latest version|最新版本
latin american|拉丁美洲
leading brands|領導品牌
left and right|左右
left arrow key|向左鍵
length of file|檔案的長度
less-than sign|小於符號
letter spacing|字距
level complete|過關
lighting model|照明式樣
lightning talk|閃電講
lightslategray|淺青灰
lightsteelblue|淺鋼青
line buffering|線緩衝
ln %d , col %d|列 %d，行 %d
ln %i , col %i|列 %i，行 %i
load balancing|負載平衡
local variable|區域變數
locale setting|系統語言設定
logical object|邏輯物件
logical sector|邏輯區
make it better|讓它更好
make sure that|確定
many thanks to|十分感謝
marked section|標記段落
math operation|數學運算
matters to you|與您有關的
maximum volume|最大音量
mediumseagreen|暗海藻綠
message header|訊息標頭
message number|訊息編號
message source|訊息源
message thread|郵件串
message-driven|訊息驅動
meta-signaling|中繼信號方式
meteorological|氣象
microprocessor|微處理器
migration from|遷移自
missing person|失蹤者
model matrices|式樣矩陣
monospace font|等寬字型
more than once|一次以上
multi-language|多語言
multiple times|多次
multiplication|乘法
multiplicative|倍數
multiprocessor|多處理器
multiselection|多重選取
named argument|具名引數
native library|原生庫
native speaker|原生語言使用者
navigation bar|導覽列
negative entry|負值進入
negative range|負值範圍
next paragraph|下一段落
no-break space|非間斷空白
non-commercial|非商業
nonrepudiation|不可否認性
north american|北美
not be able to|不能
not big enough|不夠大
not interested|不感興趣
not registered|未註冊
null character|空字元
number of days|天數
numeric keypad|數字鍵臺
off by default|預設關閉
on your behalf|代表您
one of the two|兩者之一
one place down|向下一個位置
operating mode|作業模式
operation code|運算碼
optical energy|光能
optimizer hint|最佳化提示
out of service|中止服務
out-of-process|跨行程
overall rating|整體評價
packet-writing|封包寫入
pair character|成對字元
parent process|上層行程
part of speech|詞性
participate in|參與
partition size|分割區大小
partition type|分割區類型
password aging|密碼生命期
payment method|付款方式
periodic table|周期表
physical block|物理區段
place an order|下訂
please contact|請聯絡
point on curve|曲線上的點
point-to-point|點對點
portable drive|可攜式磁碟
portrait right|螢幕向右轉直
positive value|正值
pound sterling|英鎊
pre-designated|預先指明
preferred form|首選形式
previous frame|上一影格
previous track|上一曲目
primitive type|基本類型
print in color|彩色列印
privacy policy|隱私政策
process status|行程狀態
profiling data|規範檔資料
protocol class|協定級別
proxy settings|代理伺服器的設定
pseudo-classes|假擬類別
public network|公眾網路
pull-down menu|下拉式功能表
qualified name|限定名稱
quasiquotation|半引號
quotation mark|引號
race condition|競爭情況
randomize list|隨機排列
really want to|真的要
reason unknown|理由不詳
recent project|最近使用的專案
recommendation|建議事項
recordset-type|資料錄集類型
redundant data|備用資料
reference data|參照資料
release button|放開按鈕
release number|釋出編號
remaining time|剩餘時間
remote process|遠端行程
removable disk|抽取式磁碟
report bugs to|將錯誤報告給
representation|表述
required field|必填欄位
responsibility|責任
retransmission|轉發
return address|回覆位址
return receipt|回覆回條
reverse charge|退費
reverse polish|逆波蘭
rhaeto-romance|里托羅曼語
rotation speed|轉速
rounding error|捨入誤差
rubber-banding|用橡膠帶繫縛
runtime checks|執行時檢查
russian rouble|俄羅斯盧布
save bandwidth|節省頻寬
save selection|儲存選取項目
scroll by line|逐列捲動
second to last|倒數第二
section header|小節標頭
security token|安全代表字組
select inverse|反向選擇
select-by-word|字詞選取依據
self-contained|獨立的
self-reference|自我參考
semi-automatic|半自動
separated file|分隔檔案
separator line|分隔線
serbo-croatian|塞爾維亞克羅埃西亞語
server process|伺服器行程
server program|伺服程式
set as default|設成預設值
set-comparison|集合比較
shared library|共用函式庫
shift function|移位函數
shift operator|移位運算子
sign languages|手語諸語言
single channel|單頻道
single sign-on|單一登入
sint eustatius|聖尤斯特歇斯
small capitals|小型大寫字母
something else|其他東西
something like|諸如
somewhere else|其他地方
sort ascending|遞升排序
source element|原始元素
source package|原始碼套件
south european|南歐語言
spaces to tabs|空格轉為跳格
spanish peseta|西班牙陪士特
special thanks|特別感謝
specialization|特殊化
specific-error|特定錯誤
stack overflow|堆疊上限溢位
starting frame|起點影格
state/province|州╱省
stop recording|停止錄製巨集
storage device|貯藏裝置
storage object|貯藏物件
storage system|貯藏系統
stream bitrate|串流位元
stroke penalty|罰桿
sub-addressing|副址
sub-dependency|子依存
surreal number|超現實數
surround sound|環繞音效
susceptibility|磁化率
sustainability|延續性
swap partition|交換分割區
symphonic rock|交響搖滾
system failure|系統故障
tabs to spaces|跳格轉為空格
tail-recursive|尾部遞迴
take advantage|利用優勢
take ownership|取得所有權
take some time|花一點時間
target machine|目標電腦
television set|電視機
temporary file|暫存檔
terminal pager|終端機分頁器
text selection|文字選取
text-delimiter|文字分隔符號
text-to-speech|文字轉語音
there are some|有一些
time remaining|剩餘時間
tip of the day|本日祕訣
to make use of|以利用
too many times|太多次
topmost window|最上層顯示視窗
total capacity|總容量
transfer money|轉賬
transformation|變換
transmultiplex|轉多工
trying hard to|一直致力於
tunisian dinar|突尼西亞戴納
tupi languages|圖皮諸語言
type qualifier|類型限定詞
type to search|輸入搜尋
type-reference|型態參考
ultracondensed|超緊縮
unable to find|無法找到
unavailability|不可用性
under the hood|內含功能
unexpected end|未預期結束
unfortunately,|很不幸，
uninstallation|解除安裝
united kingdom|英國
up and running|啟動並執行
user-rejection|使用者拒絕
user-specified|使用者指定
variable width|可變寬度
version number|版本編號
vertical ruler|垂直標尺
very committed|十分堅定
videomessaging|影片訊息
virgin islands|維京群島
virtualization|虛擬
volume control|音量控制
vt-association|虛擬終端機結合
warrant canary|令狀金絲雀
western europe|西歐
when available|若是可用
when they next|當他們下次
whether or not|是否
window borders|視窗邊線
window gravity|視窗重要性
with a view to|為了
with an eye to|為了
with regard to|相關於
word processor|文書處理程式
working online|線上工作模式
world wide web|全球資訊網
you can always|您隨時能夠
you experience|您遇到
zambian kwacha|尚比亞克瓦查
"alternatively,|或者是，
a file or files|一個或多個檔案
abstract method|抽象方法
accelerator key|加速鍵
accented letter|揚音字母
acknowledgement|認可
acoustic energy|聲能
active document|主動式文件
actual argument|實際引數
add application|新增應用程式
additive-stream|相加流
address-mapping|位址映射
advanced filter|進階篩選
afars and issas|阿法爾及伊薩
align to bottom|對齊底部
alpha component|透明成分
ambiguous-width|兩可寬度
american indian|印第安人
amount of space|空間容量
angle-spherical|球面角
anonymous union|匿名等位
area-identifier|區域識別符號
arithmetic type|算術型式
array reference|陣列參照
array subscript|陣列下標
associated file|關聯檔
attribute group|屬性群
audio recording|錄音
available space|可用空間
bahamian dollar|巴哈馬元
banda languages|班達諸語言
barbados dollar|巴貝多元
be ready to use|備妥待用
be requested to|請
be unsure about|不確定
before we start|在開始之前
binary operator|二元運算子
black and white|黑白
block quotation|區塊引用
blocking factor|區段化倍數
breakpoint trap|中斷點設陷
cabinet-mounted|機架掛載的
canadian dollar|加拿大元
canadian french|加拿大法語
capable society|有能社會
capital letters|大寫字母
carriage return|換列字元
character-based|以字元為基礎的
class hierarchy|類別階層
code of conduct|行為準則
column-oriented|欄導向
come along with|跟上
comma-separated|以逗號分隔的
complementation|取補數
completion port|完成埠
composite glyph|組合字圖
computerization|電腦化
concrete syntax|具體語法
conference call|召開會議
conference room|會議室
confidentiality|機密性
connection lost|連線已經中斷
connection path|連線路徑
connection type|連線類型
connection-mode|連接模式
const-qualified|常數限定
contemporaneous|同時
continue anyway|無論如何都繼續
continuous tone|連續色調
control library|控制項函式庫
conversion type|轉換型式
cross-reference|交叉參照
current element|現行元件
current process|目前行程
current session|目前的階段作業
custom proofing|自行驗證
data dictionary|資料辭典
database cursor|資料庫指標
deconcatenation|解序連
decrease volume|減少音量
dependency file|依存檔案
deserialization|還原序列化
desktop session|桌面階段作業
direct-attached|直接附接式
diskless client|無本地磁碟的客戶端
display setting|顯示器設定
do not yet have|還沒有任何
document number|文件號碼
double japanese|雙重日式
dual-attachment|雙附件
dynamically-set|動態設置
electric energy|電能
embedded object|內嵌物件
enclosing class|封入類別
enumerated type|枚舉型式
error condition|錯誤狀況
error indicator|錯誤指示符
evaluation copy|試用版
everything else|其他所有
exact multiples|精確倍數
executable file|可執行檔
exit and return|退出後回到
expiration date|過期日期
expiration time|過期時間
extended header|擴充標頭
external source|外部資料來源
eyedropper tool|滴管工具
factor analysis|因素分析
falling back to|降抵為
false otherwise|否則為假
fault tolerance|容錯
feel free to do|儘管去做
file descriptor|檔案描述符號
file identifier|檔案識別符號
filtered stream|已篩選的串流
fixed attribute|固定屬性
forget about it|不管它
formal argument|形式引數
french republic|法蘭西共和國
from each other|各個
fully qualified|完全合格
function result|函數計算結果
general purpose|一般用途
get you started|帶您入門
global progress|整體進度
go one level up|前往上層
gracious thanks|由衷的感謝
graphic library|繪圖函式庫
halt-line-state|暫停線路狀態
have a habit of|習慣會
have a nice day|祝您一天都順利
have a question|有疑問
have non of the|不具任何一個
high throughput|高通量
horizontal line|水平線
how things work|事物如何運作
huizhou chinese|漢語徽語
hyperbolic sine|雙曲正弦
idle-line-state|閒置線路狀態
imported symbol|匯入符號
in no time flat|立刻
in the meantime|趁這時
in view of this|有鑑於此
increase volume|增加音量
indemnification|保障
indic languages|印度諸語言
indic-malayalam|印度－喀拉拉語
indivivsibility|不可跨頁
instance number|實例數量
instruction set|指令集
interconnection|互連
interestingness|感興趣度
internal memory|內記憶體
internet socket|網際網路通訊端
interval number|區間號碼
isdn connection|ISDN 連接
isolation level|隔離層級
it is important|是相當地重要
jamaican dollar|牙買加元
kangxi radicals|康熙部首
karachay-balkar|卡拉恰伊－巴爾卡爾語
karen languages|克倫諸語言
keyboard layout|鍵盤佈局
leave empty for|留空表示
leave unchanged|保持不變
leftwards arrow|向左箭號
liberian dollar|賴比瑞亞元
load on startup|啟動時載入
local directory|本機目錄
local selection|局部選取區域
locale-specific|語區特定的
location number|位置號碼
looks promising|前景看好
lower to bottom|降到最下層
macro expansion|巨集展開
macrodefinition|巨式定義
magnetic energy|磁能
mail user agent|郵件使用者代理程式
maintainability|維護性
make an invoice|開立發票
many thanks for|十分感謝
mass production|量產
master document|主控文件
master instance|主控實例
master password|主控密碼
maximize button|最大化按鈕
maximize window|將視窗放到最大
mediumslateblue|暗青藍
mediumturquoise|暗粉藍
mediumvioletred|暗紫紅
memory exceeded|超出記憶體
merchantability|適銷性
message catalog|訊息目錄
meta-signalling|中繼信號方式
min bei chinese|漢語閩北語
min nan chinese|漢語閩南語
minimize button|最小化按鈕
minimum version|最低版本
monitor message|監控訊息
more accessible|更方便
moroccan dirham|摩洛哥迪拉姆
multiprocessing|多重處理
munda languages|蒙達諸語言
musical symbols|音樂符號
must be between|必須介於
must be present|必須要出現
name resolution|名稱解析
named parameter|具名參數
native american|北美原住民音樂
navigation keys|導覽鍵
neither of them|它們都沒有
network adapter|網路卡
no action taken|未採取任何行動
no rule to make|沒有規則用來製作
non-disjunction|非分離
non-enforcement|不予執行
non-interactive|非互動
nonempty string|非空字串
norwegian krone|挪威克朗
not implemented|未實作
not long enough|長度不夠
not necessarily|未必
nothing special|沒什麼特別
notwithstanding|不管
null terminator|空終端子
null-terminated|零值終結
numerical aware|數值內容
numerical value|數值
object oriented|物件導向
object-oriented|以物件為導向的
obligatory note|義務提醒
offset to entry|進入點偏移值
opening address|開幕致辭
optical storage|光學貯藏器
over accelerate|過度加速
packet-switched|分封交換
pages per sheet|每張紙的頁數
parameter-label|參數標貼
partition start|分割區開始
partition table|分割區表
personalization|個人化
playback volume|播放音量
please consider|請考慮
plug-compatible|插接相容的
plus-minus sign|加減符號
point downwards|指向下方
pointing device|定位裝置
positive number|正數
post processing|後續處理
post-production|後製
power efficient|節能
prefix notation|前置記法
primary display|主顯示
print in colour|彩色列印
print this page|印出這一頁
private network|專用網路
pu-xian chinese|漢語莆仙話
public announce|公佈
range selection|範圍選取
rational number|有理數
reconfiguration|重新組態
record boundary|記錄界限
record-oriented|記錄導向
redistributable|可再散佈
reference count|參照次數
registered sign|已註冊符號
removable drive|可移除式儲存裝置
request to send|請求發送
responsible for|負責
restricted mode|限定模式
retransmissions|轉發次數
revert to saved|回復原儲存狀態
revision number|修訂版號碼
right arrow key|向右鍵
rotation offset|旋轉補償
sample filename|檔案名稱範例
save project as|專案另存為
script property|指令稿性質
search backward|向後搜尋
search criteria|搜尋條件
search forwards|向前搜尋
secondary pages|後續頁面
section element|節元素
sector-pairwise|區段成對
secure protocol|安全協定
selected option|所選項目
self-confidence|自信
self-delimiting|自定界
sequence number|序號
setup completed|設定完成
shared resource|共用資源
short reference|簡短參考
single-clicking|單按一下
single-threaded|單一執行緒
sink connection|匯集連接
slovenian tolar|斯洛維尼亞托勒
so that you can|這樣您就能夠
software bundle|軟體套組
something weird|情況很怪異
something wrong|有點問題
sort descending|遞降排序
spaces and tabs|空格與跳格字元
specific option|特定選項
square brackets|方括號
standardization|標準化
start condition|起始條件
streaming media|串流媒體
structured-name|結構化名稱
substituted for|用以替代
sumero-akkadian|蘇美亞喀得
synchronization|同步化
syntax coloring|語法着色
take care of it|想想辦法
take screenshot|拍下螢幕快照
teletranslation|電視翻譯
temporary files|暫存檔案
texture mapping|材質貼圖
the last record|最後一筆
thermal printer|熱感式印表機
this connection|這一連線
threshold value|臨界值
thrown together|齊拋
tile vertically|垂直並排
times new roman|Times New Roman
to be continued|待續
to make a shape|以成形
transaction log|異動日誌檔案
transaction set|異動集
transliteration|實字轉譯
transport layer|傳輸層
tropical forest|熱帶雨林
trust territory|託管地
try again later|稍後再試一次
type descriptor|類型說明符號
under the terms|遵循條款
unintentionally|無意地
uninterpretable|不可解譯
value-reference|數值參考
vanilla version|原初版本
variable-length|可變長度
verbatim blocks|字面區塊
version-control|版本控制
vertical blinds|垂直百葉窗
video recording|錄影
video-on-demand|隨選視訊
volatile memory|揮發性質記憶體
volume creation|卷冊建立日期
what this means|這表示什麼
wibble a wobble|搖來搖去
window behavior|視窗運作方式
with respect to|相關於
word completion|自動補完字詞
working offline|離線工作模式
workspace pager|工作區切換器
write-protected|防止寫入的
yijing hexagram|易經爻掛
you are advised|建議您
yupik languages|尤皮克諸語言
zande languages|贊德諸語言
zimbabwe dollar|辛巴威元
zoom in and out|放大和縮小
zoom percentage|縮放顯示比例
"acknowledgments|致謝
access violation|違規存取
across the world|於全世界
active title bar|現用視窗標題列
ad-hoc volunteer|短期志工
adder-subtracter|加減器
after a few days|幾天之後
altaic languages|阿爾泰諸語言
alternative text|替代文字
always on bottom|最下層
animals & nature|動物 & 自然
apache languages|阿帕契諸語言
argument missing|缺少引數
around the world|全世界
at the same time|同時
at your own risk|風險請自負
attachment point|附接點
auto-acknowledge|自動告知
auxiliary vector|輔助向量
baltic languages|波羅的諸語言
be accustomed to|習慣
be equivalent to|相當於
be not installed|還沒有安裝
be not supported|並不支援
be used together|一齊使用
be working on it|正在努力中
binary operation|二進運算
bit manipulation|位元操作
bootstrap loader|啟動載入程式
braille patterns|盲文
breakout session|分組會議
can be addictive|是會上癮的
can be dangerous|可能有危險
can not be empty|不可為空
can only be used|衹能使用
caret navigation|鍵盤導覽
carrier-standard|載體標準
case insensitive|大小寫不須相符
central american|中美洲
central european|中歐語言
chamic languages|占語諸語言
character height|字母高度
character number|字元數
character offset|字元位移
character string|字串
checking program|查驗程式
clipboard format|剪貼簿檔案格式
close and return|關閉並返回
column-set-model|欄集合式樣
command argument|指令引數
commercial usage|商業用途
compilation unit|編譯單元
composite widget|組合式視窗元件
conditional jump|條件式跳位
config directory|組態目錄
connection error|連線錯誤
connection setup|連接建立
constant bitrate|固定位元率
constrain around|約束
contention-loser|競爭輸家
control property|控制項性質
copy constructor|副本建構函式
copy propagation|副本傳用
copyright notice|著作權備註
counter proposal|相對提案
counter-pressure|感壓
counterclockwise|逆時針
creative commons|創用 CC
current position|現行位置
database manager|資料庫管理者
delimited-string|限制字串
design-time-only|僅限設計時期
desktop computer|桌上型電腦
device-dependent|依存於裝置的
diacritical mark|讀音符號
direct reference|直接參考
directory record|目錄錄
display function|顯示函數
distance between|間距
distraction-free|無干擾
do you mind that|如果您不介意，
double buffering|雙重緩衝
double precision|雙倍精度
double-precision|倍精度
during idle time|在閒置期間
edge enhancement|邊緣強化
either version 2|無論您依據的是本授權的第二版
encoded in utf-8|以 UTF-8 編碼
english language|英語
enumerated value|枚舉值
error correction|錯誤更正
error-corruption|資料損壞
evaporation heat|蒸發熱
even better than|甚至優於
every-other-line|跳線式
exclamation mark|驚嘆號
exit immediately|立即退出
explicit request|外顯請求
factory defaults|出廠預設值
factory settings|出廠設定
file to download|要下載的檔案
find in software|在軟體中尋找
first and second|第一和第二
floating element|浮動元素
for this purpose|為了這個目的
formal parameter|形式參數
french polynesia|法屬玻里尼西亞
generated-object|產生的物件
get started with|開始使用
giving me a hand|助我一臂之力
half an hour ago|半小時之前
hearing impaired|聽障者
here you can see|您可在這裡看到
highly recommend|強烈建議
host application|主應用程式
if memory serves|如果沒記錯
if not, write to|如果沒有則請寫信到
important to see|值得一看
in a few minutes|幾分鐘後
in bright colors|以亮色
in spite of this|儘管如此
incomprehensible|難以理解
information file|資訊檔
intended purpose|預定目的
interactive mode|互動模式
internationalize|國際化
interoperability|交互操作性
invalid encoding|無效編碼
invalid filename|檔名無效
italian republic|義大利共和國
key encipherment|金鑰編密
language element|語言項目
last active mode|上次作用模式
leave it checked|保持已勾選狀態
left parentheses|左括號
left parenthesis|左括號
left uncorrected|懸而未解
level adjustment|位準調整
lexical analysis|詞彙分析
lexical analyzer|詞彙分析器
light background|明亮背景
linked-operation|鏈結操作
literary chinese|漢語文言
lithuanian litas|立陶宛立特
local interfaces|本機介面
locale-dependent|語區依存的
logical operator|邏輯運算子
luxembourg franc|盧森堡法郎
macrodeclaration|巨式宣告
macroinstruction|巨式指令
make the payment|進行付款
mandarin chinese|漢語官話
manobo languages|馬諾博諸語言
marked as active|標記為作用中
marshall islands|馬紹爾群島
maximized window|最大化視窗
mediumaquamarine|暗草綠
memory alignment|記憶體對位
microinstruction|微指令
microprogramming|微程式規畫
min dong chinese|漢語閩東語
minimized window|最小化視窗
misappropriation|盜用
modem connection|數據機連線
multidimensional|多維
multiprogramming|多重規畫
musical notation|樂譜記號
must be positive|必須是正值
name token group|名稱字組群
navigate forward|向前導覽
nested structure|巢狀結構
noise-line-state|雜訊線路狀態
non-data-capable|非數據能力
non-transferable|不可轉讓
nubian languages|努比亞諸語言
number of frames|影格數
object inspector|物件檢查器
object reference|物件引用
octet-structured|八位元組結構
offscreen buffer|螢幕關閉的緩衝區
on completion of|於完成時
one on each side|每邊一個
one-way-recovery|單向復原
open connections|開啟連線
open parentheses|開放的括號
open parenthesis|開放的括號
operating system|作業系統
original setting|原始設定
overall progress|整體進度
papua new guinea|巴布亞紐幾內亞
partition number|分割區編號
perpendicular to|垂直於
phonetic symbols|音標符號
playback control|播放控制
positive integer|正整數
power management|電力管理
pre-dependencies|預先依存
pre-installation|安裝前
previous chapter|上一章節
primary language|主語言
printer-friendly|適合列印的
private colormap|個人顏色對照表
progressive rock|前衛搖滾
proprietary-data|專有資料
protected method|受保護的方法
protocol-version|協定版本
psychedelic rock|迷幻搖滾
public directory|公共目錄
punctuation mark|標點符號
quadratic spline|二次曲線
query-expression|查詢表示式
quiet-line-state|靜止線路狀態
ready to be read|準備好可供讀取
reference-object|參考物件
related sections|相關章節
relative address|相對位址
relocation entry|重新配置登錄
remain unchanged|保持不變更
remains in place|保持原狀
remember forever|永久記住
rendering intent|潤算比對方式
replace in files|檔案中置換
requires a value|需要一個值
return to normal|回復正常
right to privacy|隱私權
rightwards arrow|向右箭號
root certificate|主要憑證
root-mean-square|均方根
saint barthelemy|聖巴托洛繆島
secondary prompt|輔助提示
secondary server|輔助伺服器
security concern|安全上的考量
self-explanatory|不解自明的
semi-transparent|半透明
server extension|伺服器擴充
service-provider|服務提供者
service-specifie|服務特定的
session-specific|階段作業特定的
set-intersection|集合交集
shutter priority|快門先決
significant part|有效數位部分
singapore dollar|新加坡元
single precision|單精確度
single-connector|單連接器
single-precision|單精度
siouan languages|蘇語諸語言
site information|網站資訊
skip straight to|直接跳到
slide transition|投影片切換
source directory|原始目錄
spelling checker|拼寫檢查
split vertically|垂直分割
spring-sensitive|自動開合式
stack allocation|堆疊配置
storage capacity|貯藏容量
storage location|貯藏位置
structured block|結構化訊息塊
suspicious stuff|惡意材料
switch statement|開關敘述
synchronizeminor|次同步
synchronous mode|同步模式
telcommunication|電信
telephone number|電話號碼
terms of service|服務條款
there is already|已經有
there is nothing|沒有東西
this is normally|通常這是
to the selection|於所選
toggle selection|切換選取
trading position|交易倉位部位
trailing context|尾隨情境
translation type|轉譯類型
translation unit|轉譯單位
tristan da cunha|崔斯坦達庫尼亞群島
two-phase commit|二階段定稿
two-way-recovery|雙向復原
type-declaration|型態宣告
unexpected error|非預期錯誤
unformatted text|未格式化的文字
unless otherwise|除非另外
unpredictability|不可預測性
unqualified type|非限定型式
user-application|使用者應用
variable bitrate|可變位元率
vedic extensions|吠陀梵文
vertical spacing|垂直間距
voice-activation|聲音活化
western european|西歐語言
what is going on|正在進行中的
when it comes to|一提到
whole words only|必須全字相符
work in progress|正在進行工作
wrapper function|包繞函式
zero-based index|以零為基準的索引
"acknowledgements|致謝
a group of people|一群人
absolute position|絕對位址
active-line-state|現用線路狀態
after a paragraph|段落之後
already installed|已經安裝的
ambient occlusion|環境光吸收
any later version|任何後續的版本
aperture priority|光圈先決
application layer|應用層
arrange selection|排列選取範圍
ask me this again|再問我這個
association table|關聯表
astronomical data|天文學資料
australian dollar|澳大利亞元
auto gain control|自動增益控制
autoconfiguration|自動組配
be already in use|已在使用中
be continued from|延續自
be invalid for %s|對於 %s 無效
be not interested|並不感興趣
be not registered|還沒有註冊
be provided as is|係依現狀提供
binary compatible|二進位相容的
boolean operation|布林運算
brunei darussalam|汶萊
call it like this|以此稱呼它
certificate chain|憑證鏈
cipher preference|密碼喜好設定
cjk compatibility|中日韓相容
client and server|主從
close all windows|關閉所有視窗
close parentheses|關閉的括號
close parenthesis|關閉的括號
completion packet|完成包
complex conjugate|共軛複數
connect to server|連接伺服器
connectioendpoint|連接端點
container-managed|容器管理式
contention-winner|競爭贏家
context sensitive|語境相關
contraindications|禁忌徵候
contrary behavior|相反動作
correction factor|修正因子
costa rican colon|哥斯大黎加科郎
counter clockwise|逆時針
cross-application|跨應用程式
cross-device link|跨裝置鏈結
current attribute|現行屬性
current selection|目前的選取
database settings|資料庫的設定
decimal separator|小數點符號
devote himself to|致力於
directional light|方向燈
directories first|目錄前置
discussion thread|討論串
do not care about|不要去管
do not want to|不想要
edition statement|版本敘述
enhanced metafile|加強型中繼檔案
error information|錯誤資訊
every few minutes|每隔幾分鐘
every-other-pixel|跳像素
explicit language|不雅語句
failed with error|失敗而産生錯誤
feather selection|羽化選取範圍
field-replaceable|可現場置換的
file system table|檔案系統表
filling-direction|填入方向
firmware revision|韌體修訂版本
floating constant|浮點常數
for some time now|已有一段時間
formal definition|形式定義
forward one frame|進一影格
forward reference|向前參考
from unauthorised|免於未授權
garbage collector|記憶空間回收器
general delimiter|通用分隔符號
have access to it|能夠存取它
have the power to|有權力去
hexadecimal digit|十六進位數字
hyperbolic cosine|雙曲餘弦
identifier prefix|識別碼前置詞
image enhancement|影像增強
independent state|獨立國
industry-standard|工業標準
information about|相關資訊
information field|資訊欄
instant messenger|即時傳訊
instruction cache|指令快取記憶體
instrumental rock|純樂器演奏搖滾
intelligent crime|智能型犯罪
intermountability|互裝性
internet explorer|網路探險家
internet protocol|網際網路通訊協定
interrupt handler|中斷處理常式
invalid character|無效字元
iranian languages|伊朗諸語言
isopropyl alcohol|異丙醇
it makes no sense|這無意義
it will be useful|它能夠有用
japanese envelope|日式信封
japanese postcard|日式明信片
khoisan languages|科伊桑諸語言
left mouse button|滑鼠左鍵
license agreement|授權協議
lines in the text|文字列
logical partition|邏輯分割區
loss-of-tributary|支路漏失
lossy compression|有損壓縮
maintenance panel|維護板
malaysian ringgit|馬來西亞林吉特
manual page break|手動分頁
master-line-state|主線路狀態
meaningful to you|對您有意義
mediumspringgreen|暗嫩綠
meeting the needs|合乎需要
memory allocation|記憶體配置
message subthread|子郵件串
messaging service|訊息服務
min zhong chinese|漢語閩中語
misrepresentation|不實表述
more specifically|更明確地
motion estimation|動畫預估
multi-dimensional|多維式
multipart-message|多部件訊息
nahuatl languages|納瓦特諸語言
named in honor of|以為名
network computing|網路運算
network-addresses|網路位址
new taiwan dollar|新臺幣
non-straight arms|非直臂
norwegian nynorsk|新挪威語
not authorized to|未授權
not enough memory|記憶體不足
numeric character|數字字元
numeric parameter|整數參數
object identifier|物件識別符號
one suspects that|一般認為
operation aborted|已放棄操作
operation pending|操作擱置
optional argument|可選引數
otomian languages|奧托米諸語言
outgoing messages|外寄郵件
paint bucket tool|油漆桶工具
pass by reference|傳址
password required|必須輸入密碼
payment processor|付款機制
perform operation|進行作業
periodic interest|定期利息
permanent storage|永久貯藏區
permanent-failure|永久故障
permission denied|未獲許可
personal computer|個人電腦
platform-specific|特定平臺的
point of interest|趣點
pointer to member|成員指標
post-installation|安裝後
prakrit languages|普拉克里特諸語言
preformatted text|預格式化的內文
presentation file|展示檔案
primary selection|主選取
programming model|程式撰寫式樣
prompt for action|動作提示
public identifier|公開識別符號
quality assurance|品質管制
quoted identifier|引號識別項
reach more people|接觸更多人
reason to believe|理由相信
recoverable error|可復原的錯誤
red eye reduction|消除紅眼
remote connection|遠端連線
remove duplicates|移除重複者
restart numbering|重新開始編號
resynchronization|再同步
right parentheses|右括號
right parenthesis|右括號
romance languages|羅曼諸語言
rotational energy|旋轉動能
run in background|在背景執行
run out of memory|記憶體用完
samples per pixel|像素取樣數
save selection as|選取區另存為
save when closing|關閉時自動儲存
script management|指令稿處理
self intersecting|自我交叉
self-registration|自行註冊
semitic languages|閃語諸語言
service-data-unit|服務資料單元
service-unit-data|服務單元資料
short description|簡短描述
should be avoided|應該要避免
should be careful|應該要小心
shunned character|避開的字元
side-by-side mode|並列模式
significant digit|有效數位
soft-dependencies|軟性依存
songhai languages|桑海諸語言
special thanks to|特別感謝
spectrum analyzer|頻譜儀
state or province|州或省
string expression|字串表示式
string terminator|字串結束符號
system-identifier|系統識別符號
system-management|系統管理
table of contents|目次
take a screenshot|拍下螢幕快照
take this time to|利用這段時間去
techno-industrial|數位合成工業音樂
telecommunication|電信
temperature scale|溫標
tile horizontally|水平並排
togolese republic|多哥共和國
transport and map|運輸與地圖
two-way-alternate|雙向替換
unallocated space|未配置的空間
unique identifier|惟一識別符號
unknown extension|不明的延伸名
unsigned integers|不帶正負號整數
variable argument|可變個數引數
wallis and futuna|沃里斯及伏塔那群島
whenever possible|儘可能
whenever you want|隨時
with a few clicks|按幾個鍵
working directory|工作目錄
would you like to|您想要
you are satisfied|您覺得滿意
-have already been|已
account expiration|賬號過期
address resolution|位址解析
advise transaction|建議異動作業
after installation|於安裝之後
already installed"|已經安裝
application window|應用程式的視窗
argentine republic|阿根廷共和國
atomic transaction|不可分割的作業事件
austrian schilling|奧地利先令
authentication key|認證金鑰
background process|背景行程
base document type|基本文件型式
be and will remain|是且一直會是
be not corrent for|不適用於
before a paragraph|段落之前
bibliographic file|文獻檔案
bibliography entry|參考文獻目錄條目
bilinear filtering|雙線性過濾
block special file|區段特殊檔案
boolean expression|布林表示式
brazilian cruzeiro|巴西克魯薩多
build-dependencies|組建依存
challenge-response|詰問－應答
chatham house rule|漆咸樓原則
chinese simplified|簡化字漢語
circular reference|循環參考
collating sequence|比較序列
communication port|通訊埠
component selector|組件選取器
composition window|組字視窗
conjugate gradient|共軛梯度
contact the author|與作者聯絡
convolution kernel|疊積核心
critical extension|關鍵副檔名
cross-architecture|跨架構
currently-selected|目前所選的
cushitic languages|庫希特諸語言
customization file|自訂檔案
design by contract|契約式設計
device-independent|與裝置無關
different kinds of|不同種類的
directional smooth|定向平滑
disjoint selection|非聯結的選取
display full pages|顯示整個頁面
distinguished name|辨別名稱
distinguished-name|區別名
dominican republic|多明尼加共和國
double-click speed|連按兩下的速度
dronning maud land|毛德皇后地
during the upgrade|在升級期間
electronic shutter|電子快門
enable permanently|永久啟用
enabled by default|預設啟用
error message file|錯誤訊息檔
evaluation version|試用版
extension controls|擴充控制
filename extension|副檔名
for the first time|首次
formatted document|格式化之文件
forward references|後述參考
french translation|法語翻譯
from the selection|自所選
function profiling|函式概況表
garbage collection|記憶空間回收
germanic languages|日耳曼諸語言
gilbert and ellice|吉爾柏特及埃里斯
gracious thanks to|由衷的感謝
helper application|輔助應用程式
highly appreciated|十分感謝
highly recommended|強烈建議
horizontal spacing|水平間距
hyperbolic tangent|雙曲正切
implicit attribute|隱含屬性
in accordance with|相應的
in comparison with|相較於
in the first place|起先
in the last minute|一分鐘之前
infinite recursion|無限遞迴
integer multiplier|整數倍
interface designer|介面設計程式
intrinsic function|內建函式
keyboard shortcuts|快捷鍵
language selection|語言選取
language-direction|LTR
leave it unchecked|保持未勾選狀態
left-justification|左靠齊
linux distribution|Linux 散佈版
local area network|區域網路
loss-of-multiframe|多重影格漏失
management station|管理工作站
may not be able to|也許無法
message identifier|訊息識別符號
multiple documents|多份文件
multiple selection|多重選取
multiple-precision|多重精確度
mutually exclusive|互斥
navigation toolbar|瀏覽工具列
network connection|網路連線
new zealand dollar|紐西蘭元
nicaraguan cordoba|尼加拉瓜科多巴
non-sgml character|非 SGML 字元
none available yet|尚未提供
normalization form|常態化形式
notification-label|通知標貼
on-screen keyboard|螢幕小鍵盤
period of validity|有效期間
persistent overlay|留存外覆空間
persistent storage|留存貯藏空間
pixel aspect ratio|像素長寬比
platform-dependent|受限於平臺的
port specification|埠規格
pre-initialization|預初始化
precompiled header|先行編譯標頭
preferred language|喜好的語言
presentation forms|展示形式
previous paragraph|上一段落
prisoner's dilemma|囚徒困境
process scheduling|行程排程
programming system|程式系統
progress indicator|進度指示符
protocol-data-unit|協定資料單元
provider-rejection|提供者拒絕
pseudo file system|假擬檔案系統
pseudo-marshalling|假擬封送處理
redirection number|轉接號碼
registration black|混合黑
regular expression|正規表示式
remaining capacity|剩餘容量
required attribute|必要的屬性
right mouse button|滑鼠右鍵
russian federation|俄羅斯聯邦
scripting language|指令稿語言
search and replace|搜尋並置換
segmentation fault|記憶體分段錯誤
selected component|所選組件
selection-tracking|選取追蹤
service identifier|服務識別符號
session properties|階段作業性質
short introduction|簡介
shortcut reference|快捷參照
signal noise ratio|信噪比
simplified chinese|簡化字漢語
single-dimensional|一維
small memory model|小型記憶體式樣
software selection|軟體選取
something is wrong|發生了某些錯誤
special thanks for|特別感謝
split horizontally|水平分割
standard compliant|標準編輯的
standard deviation|標準差
storage allocation|貯藏體配置
storage management|貯藏管理
strength reduction|複雜運算簡化
symbolic reference|符號參照
system header file|系統標頭檔案
taking much longer|花費更多時間
tied-column-subset|綁定欄子集
to elaborate a bit|大略談一下
too complicated to|太複雜而無法
transparent region|透明工作區
transport endpoint|傳輸端點
trigonometric type|三角類型
under construction|建構中
version of windows|Windows 版本
virtual destructor|虛擬解構函式
volatile-qualified|揮發限定
vt-functional-unit|虛擬終端機功能單元
wakashan languages|瓦卡時諸語言
we are approaching|即將抵達
what are you up to|您想要做什麼
what you are doing|您在做什麼
works like a charm|有神奇功效
workspace-specific|工作區特定的
written permission|手寫許可
you appear to have|看來您具有
a couple of minutes|幾分鐘
abstract declarator|抽象宣告子
address translation|位址轉換
administrative user|管理使用者
advise notification|建議通知
all rights reserved|著作權所有
antigua and barbuda|安地卡及巴布達
artificial language|人造語言
as soon as possible|儘快
automatic extension|自動補全
available databases|可用的資料庫
backward-compatible|向下相容的
be split in 2 parts|分為兩部分
be this intentional|這是有意要如此做的嗎
be you ok with that|確定這樣可以嗎
becomes even better|變得更好
canadian aboriginal|加拿大原住民語
caucasian languages|高加索諸語言
chinese traditional|傳統字漢語
choose an operation|選擇一項操作
clear all bookmarks|清除所有書籤
coded character set|編碼字元集
combining character|組合字元
command interpreter|指令解譯器
comment declaration|註解宣告
compatibility forms|相容形式
complimentary close|結尾敬語
compound expression|複合式表示式
confidence interval|信賴區間
configuration guide|組態操作指南
conflict resolution|衝突的解決方式
connection-endpoint|連接端點
connectionless-mode|免接模式
contextual sequence|語境序列
could not be loaded|無法載入
creoles and pidgins|克里奧爾混合語
dedicate himself to|專注於
default constructor|預設建構函式
dependency checking|檢查軟體依存性質
directory hierarchy|目錄階層
disable permanently|永久停用
display mode to use|要用的顯示模式
displayed correctly|正確顯示
document background|文件的背景
document-identifier|文件識別符號
download the source|下載原始碼
drive configuration|磁碟組態
driver installation|安裝驅動程式
entry is compulsory|必填
equality constraint|對等限制
erase the selection|抹除所選的範圍
ethernet connection|乙太網路連線
expedited-data-unit|快速資料單元
file name extension|延伸檔名
forward declaration|前置宣告
gracious thanks for|由衷的感謝
greenwich mean time|格林威治標準時間
have made a mistake|做錯了
history persist dir|歷來的留存目錄
hyperbolic function|雙曲線函數
implicit conversion|隱含轉換
in conjunction with|並搭配
in either dimension|長寬都是
incremental backups|遞增備份數目
index of refraction|折射率
initialization code|初始化程式碼
insufficient memory|記憶體不足
interface-data-unit|介面資料單元
internet relay chat|多人線上交談系統
keyboard navigation|鍵盤瀏覽
killing the process|砍除行程
manual column break|手動換欄
mass storage device|大型貯藏裝置
memory partitioning|記憶分割
middle mouse button|滑鼠中鍵
mon-khmer languages|孟－高棉諸語言
motion compensation|動態補償
mounted file system|已掛載檔案系統
network-connections|網路連接
non-blocking stream|非阻斷式串流
non-option argument|非任選式引數
non-reconstructible|非可重建
normal distribution|常態散佈
notation identifier|記法識別符號
on the first screen|在第一個畫面上
overloaded function|多載化函式
pairwise-escapement|成對逸出
parallel-conversion|平行轉換
pattern recognition|胚騰辨識
performance penalty|效能減退
persistent database|留存性質的資料庫
physical-connection|物理連接
plurinational state|多民族國
point-to-multipoint|點對多點
program termination|程式結束
protocol-identifier|協定識別符號
radiopharmaceutical|放射性質藥物
relative coordinate|相對座標
required permission|所需的許可
reserved identifier|保留識別符號
resource allocation|資源配置
result element type|結果元件型式
reverse engineering|逆向工程
run-length encoding|執行長度編碼
separator character|分隔字元
spanish translation|西班牙語翻譯
standard conversion|標準類型轉換
style-specification|樣式規格
successfully loaded|已成功載入
swipe from the side|從側邊滑動
temporary directory|暫存目錄
thank you for using|謝謝您使用
the availability of|能提供多少
thousands separator|千位分隔符號
three-way-handshake|三向訊號交握模式
traditional chinese|傳統字漢語
transfer-restricted|限制轉移
transition duration|轉換時間
unrecoverable error|無法復原的錯誤
variation selectors|變異選擇符號
verbose description|詳細說明
wildcard expression|萬用字元表示式
-be successfully -en|已成功
abnormal termination|異常終止
algonquian languages|阿爾岡昆諸語言
an error has occured|發生了錯誤
application launcher|應用程式啟動程式
archive symbol table|封存符號表
arithmetic operation|算術運算
arithmetic underflow|算術欠位
ask for confirmation|徵詢確認
assistive technology|輔具
athapascan languages|阿薩帕斯坎諸語言
attribution-noderivs|姓名標示－禁止改作
be particularly true|尤其是
be under maintenance|正在進行維護
canton and enderbury|坎吞及恩得伯利
capitalization error|字母大小寫錯誤
check capitalization|檢查字母大小寫
chinese (simplified)|漢語 (簡化字)
command line options|命令列引數的選項
command substitution|指令替代
conditional operator|條件式運算子
constant propagation|常數傳用
constraint violation|限制違規
context-free grammar|無關語境的語法
country of residence|所在國家
defined but not used|已定義但未使用
delimiter-in-context|語境中的分隔符號
document preferences|文件喜好設定
duplicate definition|重複定義
encrypted connection|加密連線
execution of command|命令的執行
expression evaluator|運算式評估工具
expression statement|運算敘述式
first person pronoun|第一人稱代名詞
for private use only|限私人使用
for your information|供您參考
forbidden characters|禁止使用的字元
fund and accelerator|投資與育成
general availability|通行
getting started with|入門
have no effect until|直到才會有效果
implicit declaration|蘊含宣告
in order to continue|為了要繼續進行
in the opposite case|反之
intelligent criminal|智能型罪犯
internationalization|國際化
interprocess channel|行程間通道
it is recommended to|建議
keyboard accelerator|鍵盤加速器
kludge around things|打點瑣事
leaving the files in|將檔案留在
lightgoldenrodyellow|淺金黃
line-breaking-method|分列方法
lossless compression|無損壓縮
major version number|主要版本號碼
mathematical formula|數學公式
name start character|名稱起始字元
netherlands antilles|荷屬安地列斯
network neighborhood|網路芳鄰
not enough memory to|所需記憶體不足
open document format|開放文件格式
paragraph formatting|段落格式
peer-to-peer network|對等式網路
personal certificate|個人憑證
planar configuration|平面組態
platform-independent|與平臺無關的
post office protocol|郵局通訊協定
programming language|程式語言
proprietary software|專有軟體
registered trademark|註冊商標
requires an argument|需要一個引數
restart the computer|電腦重新啟動
scientific inferiors|科學記號
security enforcement|強制安全措施
selection dialog box|選取對話框
show tips at startup|啟動時顯示祕訣
something goes wrong|有些事情不對勁
something went wrong|出了一些問題
south-eastern europe|東歐南歐語言
special thanks go to|特別要感謝
storage area network|貯藏裝置區域網路
symbolic disassembly|符號分解
symmetric encryption|對稱式加密
syrian arab republic|敘利亞
terms and conditions|條款與細則
there is no warranty|不做任何擔保
thread local storage|執行緒區域貯藏區
to keep it away from|以避開
to make arrangements|以做出安排
translational energy|平移動能
transmission channel|傳輸通道
trim trailing spaces|修剪列尾空格
undo the last action|復原上次的操作
united arab emirates|阿拉伯聯合酋長國
unresolved reference|未能解析的參照
updated successfully|已成功更新
volume amplification|音量放大
work relatively well|相對表現不錯
would you like me to|您想要我去
a little bit familiar|初步熟悉一下
ailed with error code|失敗並産生錯誤碼
alphabetic characters|字母字元
ancient greek numbers|古代希臘數字
automatically connect|自動連線
available/unavailable|有空/沒空
base document element|基本文件元件
be mutually exclusive|彼此互斥
be not touched at all|完全不會動到
be that what you want|那就是您想要的嗎
certificate authority|憑證授權機構
character recognition|字元辨識
chinese (traditional)|漢語 (傳統字)
christian gangsta rap|基督教幫派饒舌
circular dependencies|循環依存
computing environment|運算環境
contract line spacing|縮小列距
counting rod numerals|算籌記數式
delete to end of line|刪至列尾
dependency resolution|依存性質解析
distributed computing|分散式運算
documentation comment|文件註解
double-quotation mark|雙引號
dragging and dropping|拖放
easier said than done|說比做容易
east caribbean dollar|格瑞那達元
expression evaluation|運算式評估
file selection dialog|檔案選取對話框
file system hierarchy|檔案系統階層
finished successfully|成功結束
floating-point number|浮點數值
for current directory|表示目前目錄
high performance cost|耗費大量效能
implementation limits|實作範圍
intellectual property|智能財產
it is not possible to|無法
least significant bit|最低有效位元
mathematical notation|數學記號
miscellaneous symbols|各式符號
modulator-demodulator|調變器－解調器
mutual authentication|相互認證
no filename specified|未指定任何檔名
operating environment|作業環境
palestinian territory|巴勒斯坦領地
positional parameters|位置參數
premature end of file|檔案突然結束
printed circuit board|印刷電路板
public transportation|大眾運輸
pure virtual function|純虛擬函式
put you in touch with|引介給您
read-only file system|唯讀式檔案系統
ready to be installed|準備好可供安裝
related documentation|相關文件
remain in memory only|僅僅保持於記憶體
replaceable character|可置換的字元
requires %d arguments|需要 %d 個引數
saint kitts and nevis|聖克里斯多福及尼維斯
sao tome and principe|聖多美及普林西比
search completed with|搜尋結果有
sensitive information|機密資訊
synchronous operation|同步作業
terminated abnormally|異常終止
user-defined operator|使用者定義運算子
vertical refresh rate|垂直重刷率
video buffer verifier|視訊緩衝核實器
whitespace characters|空格字元
additional information|附加資訊
afro-asiatic languages|非亞諸語言
assistive technologies|輔助技術
attribution-sharealike|姓名標示－相同方式分享
austronesian languages|南島諸語言
backward compatibility|回溯相容性
be configured for this|依此而組配
be probably a bad idea|可能不是個好主意
be strictly prohibited|受到嚴格禁止
bosnia and herzegovina|波士尼亞及赫塞哥維納
cascading style sheets|階層樣式表
concatenation operator|串連運算子
concurrent connections|並行連線
contemporary christian|現代福音
context-sensitive help|語境相關的說明
duration of the update|更新期間
enclosed alphanumerics|帶括號的字圖
file transfer protocol|檔案轉移通訊協定
file you have selected|您所選檔案
finno-ugrian languages|芬烏諸語言
for debugging purposes|為了偵錯的目的
for the dust to settle|直到塵埃落定
general public license|通用公共授權
implementation-defined|由實作環境決定
implemented interfaces|實作介面
in an efficient manner|以有效率的方式
instruction scheduling|命令排程
language specification|語言技術規定
line and the following|這列以下
ln %d , col %d , ch %d|列 %d，行 %d，字 %d
mathematical operators|數學運算子
message transfer agent|訊息轉移代理
nilo-saharan languages|尼羅－撒哈拉諸語言
nyiakeng puachue hmong|創世苗文
partial specialization|局部特化
relocation information|重新配置資訊
show your appreciation|表達您的謝意
shut down the computer|將電腦關機
solomon islands dollar|索羅門群島元
south-eastern european|東歐南歐語言
southern and antarctic|南方及南極
string freeze breakage|字串解凍
successfully completed|已成功完成
successfully installed|已成功安裝
svalbard and jan mayen|冷岸群島及央棉
thread synchronization|執行緒同步
transaction processing|交易處理
validating sgml parser|能驗證的 SGML 剖析器
variable-length record|可變長度錄
virtual function table|虛擬函式表
architectural component|架構組件
artificial intelligence|人工智能
associated element type|關聯元素型式
be entirely responsible|要負完全的責任
be you sure you want to|確定要
cc attribution-noderivs|創用 CC 姓名標示－禁止改作
click on the link below|在以下的鏈結上按一下
conditional compilation|條件式編譯
contract letter spacing|縮小字距
cryptographic algorithm|加密演算法
dimension specification|維度規格
distributed environment|分散式環境
file with the same name|相同名稱的檔案
files that are this big|這種大小的檔案
from all over the world|來自全世界
i am looking forward to|我期待
i was left with nothing|我沒看到任何東西留下來
if it would work or not|是否它有作用
indo-european languages|印歐諸語言
international character|國際字元
miscellaneous technical|各式技術符號
point-to-point protocol|點對點通訊協定
preprocessing directive|前置處理器指令
the risk of losing data|遺失資料的風險
trigonometric functions|三角函數
undo the last operation|復原上次的動作
unknown escape sequence|不明的逸出序列
user with the same name|相同名稱的使用者
want to continue anyway|無論如何還要繼續
but without any warranty|但是沒有任何擔保
central african republic|中非共和國
conversion specification|轉換技術規定
digitally signed message|數位簽名的郵件
for more information see|要獲得更多資訊請參看
formal public identifier|形式公開識別符號
general purpose register|通用暫存器
graphical representation|圖形化表述
graphical user interface|圖形化使用者介面
it is highly recommended|強烈建議
may not look quite right|看起來可能不大正確
northern mariana islands|北馬里亞納群島
pluggable authentication|可即插型認證
text in the text control|文字控制項中的文字
than the maximum allowed|超過了允許的最大值
treat warnings as errors|將警訊當做錯誤
turks and caicos islands|土克凱可群島
united states of america|美利堅合眾國
what you are looking for|您要找的東西
a string of one character|單一字元字串
allocate memory space for|配置記憶體空間給
asynchronous notification|非同步告知
attribution-noncommercial|姓名標示－非商業性質
be remedied by restarting|藉由重新啟動來補救
cc attribution-sharealike|創用 CC 姓名標示－相同方式分享
differ in such a way that|不同之處在於
folder with the same name|相同名稱的資料夾
for each of them there is|它們每一個都有
fully qualified host name|完整合格的主機名稱
internet service provider|網際網路服務供應商
named character reference|具名字元參考
parent-child relationship|親子關係
required pressure timeout|壓力達標等候時間
saint pierre and miquelon|聖皮耶及密克隆群島
significant proportion of|大部分的
taiwan, province of china|中華民國
account with the same name|相同名稱的賬號
alternative representation|替代表述法
end user license agreement|使用者授權合約
extensible markup language|可延伸標記語言
feminine ordinal indicator|陰性序數指示符
frequently asked questions|常見問題集
left single quotation mark|左單引號
member initialization list|成員初始值列表
objects with the same name|同名物件
photometric interpretation|光度計判讀
please wait while printing|列印中請稍待
pointer to member function|成員函式指標
select the entire document|選擇整份的文件
straight-line depreciation|直線折舊
to the best of our ability|以我們能力所及
british antarctic territory|英屬南極洲領地
contains invalid characters|內含無效的字元
content model nesting level|內容式樣巢狀層次
french southern territories|法屬南部領地
fully qualified domain name|完全合格的網域名稱
have absolutely no warranty|完全沒有任何擔保
have successfully installed|已成功安裝
how to avoid this situation|如何避免這種情況
masculine ordinal indicator|陽性序數指示符
network address translation|網路位址轉譯
niger-kordofanian languages|尼日－剛果諸語言
numeric character reference|數值字元參考
object-oriented programming|物件導向式程式設計
relative distinguished name|相對特異名稱
right single quotation mark|右單引號
session initiation protocol|通訊初始化協定
sorry for any inconvenience|造成您的不便請多多包涵
sorry for the inconvenience|對於不方便感到抱歉
subscripts and superscripts|下標與上標
superscripts and subscripts|上標與下標
there might be inaccuracies|也許什麼地方出錯了
this program is distributed|散佈本程式
to make a rollback possible|以便於可能的回復
be you sure that you want to|您確定要
cc attribution-noncommercial|創用 CC 姓名標示－非商業性質
creative commons attribution|創用 CC 姓名標示
directory with the same name|相同名稱的目錄
have never been shown before|之前從未顯示過
principle component analysis|主成分分析
reduce the window to an icon|將視窗縮成圖示
take a long time to complete|花費長時間才能完成
without warranty of any kind|不附帶任何擔保
all your changes will be lost|您將會失去所有變更部分
interpreted parameter literal|可解譯的參數實字
lesser general public license|較寬鬆通用公共授權
simple object access protocol|簡易物件存取通訊協定
special administrative region|特別行政區
be subject to change over time|隨時會更改
british indian ocean territory|英屬印度洋領地
extensible stylesheet language|可延伸樣式表語言
for this change to take effect|為了讓這個變更生效
maximize the window at startup|啟動時將視窗放到最大
to the extent permitted by law|在法律所允許的範圍內
usually guesses this correctly|通常能夠正確猜測
mandatory for short options too|於短選項也同樣必要
fiber distributed data interface|光纖分散式資料介面
internet message access protocol|網際網路郵件存取通訊協定
saint vincent and the grenadines|聖文森及格瑞納丁
symbols not allowed in filenames|不允許用於檔名的符號
there is nothing wrong with that|那並非有什麼不對
comes with absolutely no warranty|完全不附帶任何擔保
heard island and mcdonald islands|赫德島和麥當勞群島
internet control message protocol|網際網路控制訊息通訊協定
restore the window to normal size|將視窗回存成正常大小
without even the implied warranty|亦無暗示的擔保
attribution-noncommercial-noderivs|姓名標示－非商業性質－禁止改作
great britain and northern ireland|大不列顛及北愛爾蘭
integrated development environment|整合式開發環境
omitted tag minimization parameter|省略標籤最簡化參數
simple network management protocol|簡易網路管理協定
switch to the next document window|切換到下一個文件視窗
have to be taken into consideration|必須列入考量
integrated services digital network|整體服務數位網路
mandatory arguments to long options|長選項的必要引數
attribution-noncommercial-sharealike|姓名標示－非商業性質－相同方式分享
standard generalized markup language|標準通用標記語言
united states minor outlying islands|美屬邊疆群島
cc attribution-noncommercial-noderivs|創用 CC 姓名標示－非商業性質－禁止改作
be subject to change from time to time|隨時會更改
switch to the previous document window|切換到上一個文件視窗
cc attribution-noncommercial-sharealike|創用 CC 姓名標示－非商業性質－相同方式分享
left-pointing double angle quotation mark|左尖雙角引號
right-pointing double angle quotation mark|右尖雙引號
you are free to change and redistribute it|您可以自由變更和再次散佈它
mandatory for any corresponding short options|相對應短選項的必要引數
mandatory or optional arguments to long options|長選項的必要或可選引數
merchantability or fitness for a particular purpose|對於某一特定目的之適售與適用性質
mandatory or optional for any corresponding short options|相對應短選項的必要或可選引數
free software foundation, inc., 51 franklin st, fifth floor, boston, ma|Free Software Foundation, Inc., 51 Franklin St, Fifth Floor, Boston, MA
free software foundation, inc., 51 franklin street, fifth floor, boston, ma|Free Software Foundation, Inc., 51 Franklin Street, Fifth Floor, Boston, MA
