瀨|舐
撳|㩒
棟|㢥
焮|㷫
#靚|令
嗮|澌/晒/閪/煞
#乜|物/厶(麼)
唔|毋
#咗|徂/着
#佢|渠
邊|焉
#度|道(庹)
啱|恰/然
#呢|爾/伊
嘢|也/者/邪/耶
叻|扐/㔹
嗰|該/箇
傾偈|傾蓋
#緊|亙/賡
#搵|捃
掂|定/正/直/槙/枮/扂
嘅|其/忌/己/个
啲|尐
滴|涿
#仔|崽
#甩|伆
仲|重/尚
喺|匸(繫)
#睇|睼
#危險|崖广
#來|嚟/邌
冇|無
#咩|耶
咁/噉|恁/鍳(敢)
#您|閣下
噏|嗑
咪|勿
票|飛
檔案|快勞
排|牌
第|遞
佬|孥/路
瞓|睏
嬲|獳(惱)
點|怎
錫|惜
哋|等/地
呃|訛/眲
吓|下
差勁|苴
響|嚮/向
喐|逳
號碼|冧巴
#俾|畀
#卡|咭
嘥|㩄
唞|敨(透)
#冚|咸/閤/衾/弇
#周|周
#慈|慈
#滋|滋
